sing.	AQ0CN0
pl.	AQ0CN0
masc.	AQ0CN0
fem.	AQ0CN0
Lula da Silva	NPMSO00
Amazon Prime	NPMSO00
Amazon prime	NPMSO00
Boca Juniors	NPMSO00
E. coli	NCFS000
Escherichia coli	NCFS000
haute cuisine	NCFS000
copia y pega	NCMS000
La La Land	NPCNO00
The Daily Telegraph	NPMSO00
The Economist	NPMSO00
The Guardian	NPMSO00
The New York Times	NPMSO00
The Telegraph	NPMSO00
The Times	NPMSO00
The Wall Street Journal	NPMSO00
The Washington Post	NPMSO00
Wall Street Journal	NPMSO00
Washington Post	NPMSO00
New York Times	NPMSO00
Wall Street	NPCSG00
Rolls Royce	NPCNSP0
São Paulo	NPCSG00
Downin Street	NPCSG00
quítame allá estas pajas	NCMS000
quítame allá esas pajas	NCMS000
quítame allá	NCMS000
sálvese quien pueda	NCMS000
Benjamin Constant	NPMSSP0
Luo Guanzhong	NPMSSP0
Frank Capra	NPMSSP0
Buster Keaton	NPMSSP0
mago de Oz	NCMS000
Stabat Mater	NCMN000
Giovanni Battista	NPMSSP0
Johann Sebastian	NPMSSP0
Le Pen	NPCNSP0
I+D	NCFS000
Río de la Plata	NPMSG00
Río Negro	NPMSG00
Río Grande	NPMSG00
Viña del Mar	NPFSG00
Roquetas de Mar	NPFPG00
de buena tinta	LOC_ADV
New Deal	NCMS000
Os Lusíadas	NPMPO00
Te Deum	NCMS000
Le Corbusier	NPCNSP0
dale que te dale	LOC_ADV
Le Monde	NPMSO00
Le Soir	NPMSO00
Le Mans	NPCSG00
Europa Press	NPCSO00
Ortega y Gasset	NPMSSP0
Primavera Sound	NPMSO00
día a día	LOC_ADV
hip hop	NCMS000
San Silvestre	NPCSO00
San Silvestres	NPCPO00
Guardamar del Segura	NPCSG00
de a pie	LOC_ADJ
#de pie	LOC_ADV
a pie juntillas	LOC_ADV
a pies juntillas	LOC_ADV
drag queen	NCFS000
drag queens	NCFP000
drag king	NCMS000
drag kings	NCMP000
Mona Lisa	NPFSSP0
al dente	LOC_ADJ
después de Cristo	LOC_ADV
antes de Cristo	LOC_ADV
Steven Spielberg	NPMSSP0
Immanuel Kant	NPMSSP0
Robin Hood	NPMSSP0
Golden Gate	NPMSG00
de verdad	LOC_ADV
bajo custodia	LOC_ADV
boa constrictor	NCFS000
boas constrictor	NCFP000
azul oscuro	AQ0CN0
azul marino	AQ0CN0
sin duda	LOC_ADV
a su vez	LOC_ADV
al mismo tiempo	LOC_ADV
un poco	LOC_ADV
un tanto	LOC_ADV
paso a paso	LOC_ADV
peso mosca	NCMS000
pesos mosca	NCMP000
peso pluma	NCMS000
pesos pluma	NCMP000
música dance	NCFS000
música trance	NCFS000
penalti remate	NCMS000
gotelé temple	NCMS000
tecla escape	NCFS000
placa base	NCFS000
placas base	NCFP000
datos serie	NCMP000
buses serie	NCMP000
bus serie	NCMS000
puertos serie	NCMP000
puerto serie	NCMS000
bajo mínimos	LOC_ADV
uva pasa	NCFS000
uvas pasas	NCFP000
higos pasos	NCMP000
higo paso	NCMS000
zona centro	NCFS000
carta documento	NCFS000
operación triunfo	NCFS000
Operación Triunfo	NPFSO00
dieta paleo	NCFS000
cuello pico	NCMS000
foto archivo	NCFS000
contorno de ojos	NCMS000
master class	NCFN000
niño soldado	NCMS000
niños soldado	NCMP000
niña soldado	NCFS000
niñas soldado	NCFP000
fecha tope	NCFS000
bono transporte	NCMS000
bonos transporte	NCMP000
abono transporte	NCMS000
abonos transporte	NCMP000
Oscar Wilde	NPMSSP0
Far West	NPMSG00
Lucky Luke	NPMSSP0
Brad Pitt	NPMSSP0
Beverly Hills	NPCSG00
Emilia Romaña	NPFSG00
Washington DC	NPCSG00
Open Arms	NPCSO00
III Reich	NPMSO00
Tercer Reich	NPMSO00
ex ante	LOC_ADV
ex post	LOC_ADV
ex-ante	LOC_ADV
ex-post	LOC_ADV
Library of Congress Online Catalog	NPFSO00 
Library of Congress	NPFSO00
Futbol Club	NPMSO00
Sport Club	NPMSO00
acqua alta	NCFS000
CC BY	LOC_ADJ
CC BY-SA	LOC_ADJ
CC BY-NC	LOC_ADJ
CC BY-NC-SA	LOC_ADJ
CC BY-ND	LOC_ADJ
CC BY-NC-ND	LOC_ADJ
CC0	LOC_ADJ
ex nihilo	LOC_ADV
volens nolens	LOC_ADV
Mª	NPCNSP0
M.ª	NPCNSP0
tex-mex	AQ0CN0
Tex-Mex	AQ0CN0
cara dura	NPCS000
caras duras	NPCP000
Tel Aviv	NPCS000
Pearl Harbor	NPCS000
Torrejón de Ardoz	NPCS000
tour operador	NCMS000
tour operator	NCMS000
tour operadores	NCMP000
tour operators	NCMP000
a lo menos	LOC_ADV
gallo pinto	NCMS000
alto el fuego	NCMN000
alto al fuego	NCMN000
Echo Park	NPMSG00
corre que te pillo	NCS000
al pairo	LOC_ADV
par de apriete	NCMS000
de veras	LOC_ADV
casa de Tócame Roque	NCFS000
ex novo	LOC_ADV
de novo	LOC_ADV
justicia mayor	NCMS000
justicias mayores	NCMP000
Justicia Mayor	NCMS000
data mart	NCMS000
data marts	NCMP000
piel roja	NCCS000
pieles rojas	NCCP000
Países Bajos	NPMPG00
Estados Unidos	NPMPG00
Rand Corporation	NCFSO00
RAND Corporation	NCFSO00
know-how	NCMN000
know how	NCMN000
res publica	NCFS000
a la carbonara	AQ0CN0
L'Équipe	NCMSO00
esfera armilar	NCFS000
dance pop	AQ0CN0
dance electrónico	NCMS000
Super Bowl	NPCSO00
World Trade Center	NPMSG00
Santa Coloma	NPFSG00
Theresa May	NPFSSP0
Star Wars	NPCNO00
corta-pega	NPMN000
corta y pega	NPMN000
moto club	NPMS000
moto clubs	NPMP000
call center	NPMS000
call centers	NPMP000
call centre	NPMS000
call centres	NPMP000
déjà vu	NPMNO00
ménage à trois	NPMNO00
prêt-à-porter	AQ0CN0
D'Hondt	NPCNSP0
City Bank	NPMSO00
Pol Pot	NPCNSP0
New Jersey	NPCSG00
New York	NPCSG00
New England	NPCSG00
New Mexico	NPCSG00
New Orleans	NPCSG00
New Hampshire	NPCSG00
New Providence	NPCSG00
alto cargo	NCCSO00
ex alto cargo	NCCSO00
ex altos cargos	NCCPO00
ex primer ministro	NCMSO00
ex primera ministra	NCFSO00
La Poste	NPCSO00
Santa Cruz	NPCSO00
Mar del Plata	NPCSO00
il prete rosso	NCMS000
Red Bull	NPCNO00
Johann Sebastian	NPMSSP0
La Salle	NPCNO00
cargue y descargue	NCMN000
ida y vuelta	NCCN000
paz y salvo	NCMN000
pop-up	AQ0CN0
pop up	AQ0CN0
New Deal	NCMS000
del mismo modo	LOC_ADV
ultima ratio	NCFS000
## to avoid undesired suggestions in other rules
#corona virus	NCMN000
#salva conducto	NCMS000
#pilla-pilla	NCMS000
#taca-taca	NCMS000
#salva conductos	NCMP000
#salvo conducto	NCMS000
#salvo conductos	NCMP000
#tele trabajo	NCMS000
#tele trabajos	NCMP000
##
de la Puente	NPCNSP0
Carmina Burana	NCCN000
El Abra	NPCSG00
Quintana Roo	NPCSG00
Nuevo León	NPMSG00
tira y afloja	NCMN000
Santa Claus	NPMNSP0
ceda el paso	NCMN000
Nueva York	NPFSG00
euro-zona	NCFS000
taca-taca	NCMS000
el más allá	NCMS000
boca a boca	NCMS000
voz a voz	NCMS000
boca a oreja	NCMS000
boca oreja	NCMS000
piedra-papel-tijera	NCMS000
un boca sucia	NCMS000
La Haya	NPFSG00
punto y coma	NCMN000
Mato Grosso	NPMSG00
largo y tendido	LOC_ADV
Santo Domingo	NPMSG00
del todo	LOC_ADV
piruvato deshidrogenasa	NCFS000
CIA World Factbook	NPMSO00
CIA Factbook	NPMSO00
Luz de Gas	NPCSO00
ADN polimerasa	NCFS000
ADN polimerasas	NCFP000
María del Carmen	NPFSSP0
Royal Society	NPFSO00
Royal Academy	NPFSO00
homo sapiens	NCMN000
homo habilis	NCMN000
homo erectus	NCMN000
homo antecessor	NCMN000
homo rudolfensis	NCMN000
homo ergaster	NCMN000
homo heidelbergensis	NCMN000
homo neanderthalensis	NCMN000
homo rhodesiensis	NCMN000
homo sapiens idaltu	NCMN000
homo sapiens sapiens	NCMN000
a anequín	LOC_ADV
a asentadillas	LOC_ADV
aa. vv.	Y
AA. VV.	Y
A/A	Y
ab aeterno	LOC_ADV
a barlovento	LOC_ADV
a barrisco	LOC_ADV
a base de bien	LOC_ADV
a base de	LOC_PREP
abastecimiento de agua	NCMS000
abastecimiento de agua potable	NCMS000
Abg.	Y
ab initio	LOC_ADV
ab intestato	LOC_ADV
ab irato	LOC_ADV
a boca de cañón	LOC_ADV
a bocajarro	LOC_ADV
abogado defensor	NCMS000
a bombo y platillo	LOC_ADV
a borbollones	LOC_ADV
a borbotones	LOC_ADV
a bordo	LOC_ADV
a bote pronto	LOC_ADV
ab ovo	LOC_ADV
a brazo partido	LOC_ADV
a bruces	LOC_ADV
a buena cuenta	LOC_ADV
a buena fe	LOC_ADV
a buena luz	LOC_ADV
a buenas horas	LOC_ADV
a buenas noches	LOC_ADV
a buena vista	LOC_ADV
a buen recaudo	LOC_ADV
a buen seguro	LOC_ADV
a buen tino	LOC_ADV
a bulto	LOC_ADV
a cada instante	LOC_ADV
a cada momento	LOC_ADV
a cada paso	LOC_ADV
a cada rato	LOC_ADV
a cada trique	LOC_ADV
a cada triquitraque	LOC_ADV
academia de bellas artes	NCFS000
a caja y espiga	LOC_ADV
a caliche	LOC_ADV
a cal y canto	LOC_ADV
a cambio de	LOC_PREP
a cambio	LOC_ADV
a campo raso	LOC_ADV
a campo traviesa	LOC_ADV
a cántaros	LOC_ADV
a capela	LOC_ADJ
a cappella	LOC_ADJ
a cara de perro	LOC_ADV
a cara descubierta	LOC_ADV
a carcajada limpia	LOC_ADV
a cargo de	LOC_PREP
a carretadas	LOC_ADV
a carta cabal	LOC_ADV
a casquete quitado	LOC_ADV
a causa de	LOC_PREP
a causa de que	LOC_CS
accidente de trabajo	NCMS000
accidente laboral	NCMS000
acción educativa	NCFS000
acción militar	NCFS000
acción pública	NCFS000
aceite de oliva virgen	NCMS000
a centenares	LOC_ADV
a cepillo	LOC_ADV
acept.	Y
a cerca de	LOC_PREP
acerca de	LOC_PREP
a cercen	LOC_ADV
a cercén	LOC_ADV
a chorros	LOC_ADV
ácido acético	NCMS000
ácido clorhídrico	NCMS000
ácido fólico	NCMS000
ácido láctico	NCMS000
ácido sulfúrico	NCMS000
ácido úrico	NCMS000
a cielo descubierto	LOC_ADV
a ciencia cierta	LOC_ADV
a codazo limpio	LOC_ADV
a comisión	LOC_ADV
a como de lugar	LOC_ADV
a condición de	LOC_PREP
a condición de que	LOC_CS
a consecuencia de	LOC_PREP
a continuación de	LOC_PREP
a contrahílo	LOC_ADV
a contralecho	LOC_ADV
a contramano	LOC_ADV
a contrapelo	LOC_ADV
a contrapié	LOC_ADV
a contra reloj	LOC_ADV
a corazón abierto	LOC_ADV
a cordel	LOC_ADV
a coro	LOC_ADV
a costillas	LOC_ADV
a coxcojilla	LOC_ADV
# acre pie	LOC_NC
a cruz y escuadra	LOC_ADV
acta de nacimiento	NCFS000
acta final	NCFS000
actividad artística	NCFS000
actividad económica	NCFS000
actividad empresarial	NCFS000
actividades al aire libre	NCFP000
actividad extraescolar	NCFS000
actividad financiera	NCFS000
actividad humana	NCFS000
actividad industrial	NCFS000
actividad pesquera	NCFS000
acto administrativo	NCMS000
acto impugnado	NCMS000
acto jurídico	NCMS000
actuación administrativa	NCFS000
actuación judicial	NCFS000
a cuál más	LOC_ADV
a cuatro patas	LOC_ADV
a cuatro pies	LOC_ADV
a cubos	LOC_ADV
a cuenta de	LOC_PREP
acuerdo de paz	NCMS000
acuerdo internacional	NCMS000
a cuerpo de rey	LOC_ADV
a cuerpo descubierto	LOC_ADV
a/c	Y
a. C.	Y
ad calendas graecas	LOC_ADV
ad cautelam	LOC_ADV
a. de C.	Y
ad efesios	LOC_ADV
a. de J. C.	Y
además de eso	LOC_ADV
además de	LOC_PREP
además de que	LOC_CS
a dentelladas	LOC_ADV
a dentro	LOC_ADV
a desmano	LOC_ADV
a despecho de	LOC_PREP
a despecho	LOC_ADV
a destajo	LOC_ADV
a destiempo	LOC_ADV
a D. g.	Y
ad hoc	LOC_ADV
ad hominem	LOC_ADV
ad honorem	LOC_ADV
a diario	LOC_ADV
a dicho efecto	LOC_ADV
a diferencia de	LOC_PREP
ad infinitum	LOC_ADV
ad interim	LOC_ADV
a disgusto	LOC_ADV
a distinción de	LOC_PREP
ad libitum	LOC_ADV
ad lib	LOC_ADV
ad litem	LOC_ADV
ad litteram	LOC_ADV
administración civil	NCFS000
administración del estado	NCFS000
administración educativa	NCFS000
administración general	NCFS000
administración municipal	NCFS000
admón.	Y
adm.	Y
# a donde	LOC_ADV
a dos dedos de	LOC_PREP
a dos haces	LOC_ADV
a dos manos	LOC_ADV
ad quadrantum	LOC_ADV
ad triangulum	LOC_ADV
a dúo	LOC_ADV
a duras penas	LOC_ADV
ad valorem	LOC_ADV
A. D.	Y
a efecto de que	LOC_CS
a efectos de	LOC_PREP
a empellones	LOC_ADV
aeropuerto internacional	NCMS000
a escape	LOC_ADV
a escondidas	LOC_ADV
a escondidillas	LOC_ADV
a escote	LOC_ADV
a escuadra	LOC_ADV
a escusa	LOC_ADV
a escusas	LOC_ADV
a eso de	LOC_PREP
a espaldas de	LOC_PREP
a espeta perro	LOC_ADV
a espinapez	LOC_ADV
a espuertas	LOC_ADV
a este lado de	LOC_PREP
a excepción de	LOC_PREP
a expensas de	LOC_PREP
a expensas	LOC_ADV
a fanegadas	LOC_ADV
a favor de	LOC_PREP
a fin de cuentas	LOC_ADV
a fin de	LOC_PREP
a fin de que	LOC_CS
a fines de	LOC_PREP
a flor de agua	LOC_ADV
a flor de piel	LOC_ADV
a flote	LOC_ADV
afma.	Y
afmo.	Y
a fortiori	LOC_ADV
a fuego lento	LOC_ADV
a fuerza de	LOC_PREP
a fuerza de que	LOC_CS
a/f	Y
a gachas	LOC_ADV
a gatas	LOC_ADV
agencia de protección de datos	NCFS000
agencia de viajes	NCFS000
agencia espacial europea	NCFS000
agenda electrónica	NCFS000
# agente social	LOC_NC
Agnus Dei	NCMS000
a gogó	LOC_ADV
a grandes rasgos	LOC_ADV
a granel	LOC_ADV
a graves penas	LOC_ADV
agresión sexual	NCFS000
agua destilada	NCFS000
agua dulce	NCFS000
aguas continentales	NCFP000
aguas pluviales	NCFP000
aguas territoriales	NCFP000
agua subterránea	NCFS000
agua superficial	NCFS000
a guisa de	LOC_PREP
ahí es nada	LOC_ADV
ahí le duele	LOC_ADV
a hito	LOC_ADV
ahora bien	LOC_ADV
a horcajadas	LOC_ADV
a hurtadillas	LOC_ADV
aire puro	NCMS000
aislamiento térmico	NCMS000
A. I.	Y
a jarros	LOC_ADV
a. J. C.	Y
a jornal	LOC_ADV
a junta continua	LOC_ADV
a juzgar como	LOC_ADV
a juzgar por	LOC_PREP
a la bartola	LOC_ADV
al abrigo de	LOC_PREP
a la buena ventura	LOC_ADV
a la busca de	LOC_PREP
a la chita callando	LOC_ADV
a la cola	LOC_ADV
a la espera de	LOC_PREP
a la funerala	LOC_ADV
a la inversa	LOC_ADV
al alcance de la mano	LOC_ADV
al alimón	LOC_ADV
a la manera de	LOC_PREP
a la mano de Dios	LOC_ADV
a la mitad de	LOC_PREP
a la morisma	LOC_ADV
a la mujeriega	LOC_ADV
al apa	LOC_ADV
a la papillote	LOC_ADV
a la par	LOC_ADV
a la parrilla	LOC_ADV
a la pata coja	LOC_ADV
a la pata llana	LOC_ADV
a la paz de Dios	LOC_ADV
a la pendura	LOC_ADV
a la perfección	LOC_ADV
a lápiz	LOC_ADV
a la postre	LOC_ADV
a la primera de cambio	LOC_ADV
a largas marchas	LOC_ADV
a la ronza	LOC_ADV
a las calladas	LOC_ADV
a la siga de	LOC_PREP
a la sirga	LOC_ADV
a las mil maravillas	LOC_ADV
a la sopa boba	LOC_ADV
a las primeras de cambio	LOC_ADV
a las puertas de la muerte	LOC_ADV
a las veces	LOC_ADV
a lata por canal	LOC_ADV
a la tentaruja	LOC_ADV
a la tirolesa	LOC_ADV
a la usanza de	LOC_PREP
al avemaría	LOC_ADV
a la vez	LOC_ADV
a la vez que	LOC_CS
a la vuelta de	LOC_PREP
a la zona de	LOC_PREP
al bies	LOC_ADV
al cabo de	LOC_PREP
alcaldía mayor	NCFS000
al calor de	LOC_PREP
al carboncillo	LOC_ADV
al cargo de	LOC_PREP
al centro de	LOC_PREP
al chas chas	LOC_ADV
al cien por cien	LOC_ADV
al cierre del ejercicio	LOC_ADV
al clarear el día	LOC_ADV
alcohol etílico	NCMS000
al compás de	LOC_PREP
al conjuro de	LOC_PREP
al correr de la pluma	LOC_ADV
al correr del tiempo	LOC_ADV
al decir de	LOC_PREP
al derredor de	LOC_PREP
al derredor	LOC_ADV
al desbarate	LOC_ADV
al descuido y con cuidado	LOC_ADV
al desgaire	LOC_ADV
al detall	LOC_ADV
alea iacta est	LOC_ADV
a legua	LOC_ADV
a leguas	LOC_ADV
al estricote	LOC_ADV
al filo de	LOC_PREP
al filo de mediodía	LOC_ADV
al fin de la jornada	LOC_ADV
al fin y a la postre	LOC_ADV
al fin y al cabo	LOC_ADV
al frente de	LOC_PREP
Alfz.	Y
al gratén	LOC_ADV
al grill	LOC_ADV
alguna que otra vez	LOC_ADV
algunas veces	LOC_ADV
alguno que otro	LOC_ADV
al gusto de	LOC_PREP
al hilo del viento	LOC_ADV
al hilo de mediodía	LOC_ADV
al hilo	LOC_ADV
alianza estratégica	NCFS000
a libre plática	LOC_ADV
al igual que	LOC_CS
a línea tirada	LOC_ADV
al interior de	LOC_PREP
allá se andan	LOC_ADV
allá se las avenga	LOC_ADV
allá se las componga	LOC_ADV
allá se las haya	LOC_ADV
allá se las hayan	LOC_ADV
allá se van	LOC_ADV
allende de	LOC_PREP
al libre albedrío	LOC_ADV
al lucero del alba	LOC_ADV
alma humana	NCFS000
alma mater	NCFS000
al mejor tiempo	LOC_ADV
al modo de	LOC_PREP
Almte.	Y
a lo ancho de	LOC_PREP
a lo bestia	LOC_ADV
al objeto de	LOC_PREP
a lo discreto	LOC_ADV
a lo garçon	LOC_ADV
a lo grande	LOC_ADV
a lo largo y a lo ancho	LOC_ADV
a lo largo y ancho de	LOC_PREP
a lo lejos	LOC_ADV
a lo loco	LOC_ADV
al olor de	LOC_PREP
a lo más	LOC_ADV
a lo moderno	LOC_ADV
a lomo	LOC_ADV
a lomos	LOC_ADV
a lo que parece	LOC_ADV
a lo que salga	LOC_ADV
a los cuatro vientos	LOC_ADV
a los piques	LOC_ADV
a lo sumo	LOC_ADV
a lo tonto	LOC_ADV
al otro lado de	LOC_PREP
al paño	LOC_ADV
al par	LOC_ADV
al par que	LOC_CS
al paso que	LOC_CS
al pie de fábrica	LOC_ADV
al pie de la cuesta	LOC_ADV
al pie de la letra	LOC_ADV
al pie de la obra	LOC_ADV
al poco rato	LOC_ADV
al por mayor	LOC_ADV
al por menor	LOC_ADV
al primer envite	LOC_ADV
al primer folio	LOC_ADV
al primer gallo	LOC_ADV
al primer golpe de vista	LOC_ADV
al primer impulso	LOC_ADV
al proviso	LOC_ADV
al punto que	LOC_CS
al rape	LOC_ADV
al raso	LOC_ADV
al rededor	LOC_ADV
al retortero	LOC_ADV
al rojo blanco	LOC_ADV
al rojo cereza	LOC_ADV
al sesgo	LOC_ADV
al socaire de	LOC_PREP
al socaire	LOC_ADV
al tanto de	LOC_PREP
altar mayor	NCMS000
al temple	LOC_ADV
al tendido	LOC_ADV
al tenor de	LOC_PREP
alter ego	NCMN000
al tiempo que	LOC_CS
alto comisionado de las naciones unidas para los refugiados	NCMN000
alto el fuego	NCMS000
al tresbolillo	LOC_ADV
a lumbre de pajas	LOC_ADV
a lumbre mansa	LOC_ADV
al volateo	LOC_ADV
a machamartillo	LOC_ADV
a machote	LOC_ADV
a malas penas	LOC_ADV
a mal dar	LOC_ADV
a manadas	LOC_ADV
a manera de	LOC_PREP
a mano airada	LOC_ADV
a mano armada	LOC_ADV
a manos llenas	LOC_ADV
a mansalva	LOC_ADV
a mares	LOC_ADV
a más andar	LOC_ADV
a más correr	LOC_ADV
a más ganar	LOC_ADV
a más mejor	LOC_ADV
a más no poder	LOC_ADV
a más tardar	LOC_ADV
a más ver	LOC_ADV
a más y mejor	LOC_ADV
a mata caballo	LOC_ADV
a matacaballo	LOC_ADV
a mayor abundamiento	LOC_ADV
a mazo y escoplo	LOC_ADV
ambiente de trabajo	NCMS000
ambiente familiar	NCMS000
ambiente social	NCMS000
ámbito de aplicación	NCMS000
ámbito territorial	NCMS000
A. M. D. G.	Y
a mediados de	LOC_PREP
a media ladera	LOC_ADV
a media madera	LOC_ADV
a media margen	LOC_ADV
a media rienda	LOC_ADV
a media rodilla	LOC_ADV
a medias palabras	LOC_ADV
a media voz	LOC_ADV
a medida que	LOC_CS
a mediodía	LOC_ADV
a medio hacer	LOC_ADV
a medio plazo	LOC_ADV
a medios pelos	LOC_ADV
a menos que	LOC_CS
a menudo	LOC_ADV
a mesa puesta	LOC_ADV
a millaradas	LOC_ADV
a mis anchas	LOC_ADV
a mitad de	LOC_PREP
a modo de	LOC_PREP
a montón	LOC_ADV
a mucha honra	LOC_ADV
a muerte	LOC_ADV
a muerte	LOC_AQ0CN0
a muerte o vida	LOC_ADV
a mujeriega	LOC_ADV
a. m.	Y
a nado	LOC_ADV
de nado	LOC_ADJ
a no ser que	LOC_CS
análisis clínico	NCMS000
análisis comparativo	NCMS000
análisis cualitativo	NCMS000
análisis cuantitativo	NCMS000
análisis de datos	NCMN000
análisis del discurso	NCMN000
análisis de sangre	NCMN000
análisis económico	NCMS000
análisis estadístico	NCMS000
análisis funcional	NCMS000
análisis histórico	NCMS000
análisis químico	NCMS000
anatomía humana	NCMS000
anatomía patológica	NCMS000
ancho de banda	NCMS000
ángela maría	LOC_I
# animal salvaje	LOC_NC
año de servicio	NCMS000
año fiscal	NCMS000
a nombre de	LOC_PREP
año natural	NCMS000
año sabático	NCMS000
a no ser que	LOC_CS
# antecedente personal	LOC_NC
ante diem	LOC_ADV
ante meridiem	LOC_ADV
anterior a	LOC_PREP
antes bien	LOC_ADV
antes pues	LOC_ADV
antes que nada	LOC_ADV
antiguo régimen	NCMS000
antropología cultural	NCMS000
antropología filosófica	NCMS000
anuario estadístico	NCMS000
a ojo de buen cubero	LOC_ADV
a ojos vistas	LOC_ADV
a pan y cuchillo	LOC_ADV
apartado de correos	NCMS000
aparte de	LOC_PREP
a partir de	LOC_PREP
a pasatoro	LOC_ADV
a paseo	LOC_ADV
a paso de tortuga	LOC_ADV
a paso largo	LOC_ADV
a pasto	LOC_ADV
apdo.	Y
a peón	LOC_ADV
a pesar de	LOC_PREP
a pesar de que	LOC_CS
a pesar de todo	LOC_ADV
a peso de oro	LOC_ADV
a petición de	LOC_PREP
a pica suelta	LOC_ADV
a pico de jarro	LOC_ADV
a pico	LOC_ADV
a pie firme	LOC_ADV
a pie llano	LOC_ADV
a pierna suelta	LOC_ADV
a pipiricojo	LOC_ADV
a pique de maceta	LOC_ADV
a plazo fijo	LOC_ADV
a plazos	LOC_ADV
aplicación informática	NCFS000
a plomo	LOC_ADV
a poco que	LOC_CS
a poco rato	LOC_ADV
a pocos pasos	LOC_ADV
a porfía	LOC_ADV
a porrillo	LOC_ADV
a pospelo	LOC_ADV
a posteriori	LOC_ADV
a pote	LOC_ADV
apoyo docente	NCMS000
apoyo escolar	NCMS000
apoyo financiero	NCMS000
apoyo logístico	NCMS000
apoyo psicológico	NCMS000
apoyo social	NCMS000
apoyo técnico	NCMS000
a precio de coste	LOC_ADV
aprendizaje significativo	NCMS000
a primera sangre	LOC_ADV
a primera sangre	LOC_AQ0CN0
a principios de	LOC_PREP
a priori	LOC_ADV
a prisa	LOC_ADV
a propósito de	LOC_PREP
a prorrata	LOC_ADV
a prueba de	LOC_PREP
a puchos	LOC_ADV
a puerta cerrada	LOC_ADV
a puestas	LOC_ADV
a puñados	LOC_ADV
a puño cerrado	LOC_ADV
a punta de lanza	LOC_ADV
a punta de pistola	LOC_ADV
a punta pala	LOC_ADV
a puntapiés	LOC_ADV
a punto de caramelo	LOC_ADV
a punto de	LOC_PREP
a punto de que	LOC_CS
a punto de solfa	LOC_ADV
a punto fijo	LOC_ADV
a punto largo	LOC_ADV
a pupilo	LOC_ADV
ap.	Y
a quema ropa	LOC_ADV
a quemarropa	LOC_ADV
a rachas	LOC_ADV
a raíz de	LOC_PREP
a raja tabla	LOC_ADV
a rajatabla	LOC_ADV
a ras de	LOC_PREP
a ras del suelo	LOC_ADV
a ras de tierra	LOC_ADV
a rastras	LOC_ADV
arate cavate	LOC_ADV
a ratos perdidos	LOC_ADV
a raudales	LOC_ADV
a razón de	LOC_PREP
# árbol frutal	LOC_NC
# árbol genealógico	LOC_NC
archivo general	NCMS000
a reculones	LOC_ADV
a regaña dientes	LOC_ADV
a regañadientes	LOC_ADV
a rehala	LOC_ADV
a rembolso	LOC_ADV
a remiendos	LOC_ADV
a remojo	LOC_ADV
a remo	LOC_ADV
a renglón seguido	LOC_ADV
a reo	LOC_ADV
a repecho	LOC_ADV
a repelo	LOC_ADV
a repelones	LOC_ADV
a reserva de	LOC_PREP
a resto abierto	LOC_ADV
ares y mares	LOC_ADV
a retaguardia de	LOC_PREP
a revienta cinchas	LOC_ADV
a rienda suelta	LOC_ADV
a riesgo de	LOC_PREP
a riesgo y ventura	LOC_ADV
a río revuelto	LOC_ADV
arma biológica	NCFS000
arma nuclear	NCFS000
arma química	NCFS000
a rodeabrazo	LOC_ADV
a rompejunta	LOC_ADV
a rostro firme	LOC_ADV
arquitecto técnico	NCMS000
arquitectura popular	NCFS000
Arq.	Y
arreglo floral	NCMS000
arroz abanda	NCMS000
arroz blanco	NCMS000
art déco	AQ0CN0
arte contemporáneo	NCCS000
arte dramático	NCCS000
arte medieval	NCCS000
arte moderno	NCCS000
# arte popular	LOC_NC
artes aplicadas	NCCP000
artes audiovisuales	NCCP000
art nouveau	AQ0CN0
art nouveau	NCMS000
art.º	Y
art.	Y
a ruche	LOC_ADV
A. R.	Y
Arz.	Y
a sabiendas	LOC_ADV
a salto de mata	LOC_ADV
a saltos	LOC_ADV
asamblea general extraordinaria	NCFS000
asamblea general	NCFS000
asamblea general ordinaria	NCFS000
asamblea nacional constituyente	NCFS000
asamblea plenaria	NCFS000
asamblea popular	NCFS000
a sangre caliente	LOC_ADV
a sangre fría	LOC_ADV
a sangre y fuego	LOC_ADV
a santo de qué	LOC_ADV
a sardinel	LOC_ADV
a seguir bien	LOC_ADV
a semejanza de	LOC_PREP
asesor fiscal	NCMS000
asesoría jurídica	NCFS000
asesoría legal	NCFS000
asesor jurídico	NCMS000
asesor legal	NCMS000
asesor técnico	NCMS000
así como también	LOC_ADV
así como tampoco	LOC_ADV
asilo político	NCMS000
así pues	LOC_ADV
asistencia legal	NCFS000
asistencia sanitaria	NCFS000
asistencia técnica	NCFS000
así y todo	LOC_ADV
asma bronquial	NCFS000
a sobre haz	LOC_ADV
a sobremano	LOC_ADV
a sobre peine	LOC_ADV
a so capa	LOC_ADV
a socapa	LOC_ADV
asociación civil	NCFS000
asociación de empresarios	NCFS000
asociación de vecinos	NCFS000
asociación empresarial	NCFS000
asociación profesional	NCFS000
a soga	LOC_ADV
a solapo	LOC_ADV
a solas	LOC_ADV
a solaz	LOC_ADV
a sotamano	LOC_ADV
a sotavento	LOC_ADV
a su imagen y semejanza	LOC_ADV
a suplicación de	LOC_PREP
a súplica de	LOC_PREP
a sus anchas	LOC_ADV
A. S.	Y
a tal punto que	LOC_CS
a teja vana	LOC_ADV
atención al cliente	NCFS000
atención directa	NCFS000
atención domiciliaria	NCFS000
atención médica	NCFS000
atención personal	NCFS000
atención sanitaria	NCFS000
atención temprana	NCFS000
a tenor de	LOC_PREP
a tientas	LOC_ADV
a tiento	LOC_ADV
a tirada	LOC_ADV
a tiro de ballesta	LOC_ADV
a tiro de pistola	LOC_ADV
a tiro limpio	LOC_ADV
a título de	LOC_PREP
a tizón	LOC_ADV
a toca ropa	LOC_ADV
a toca teja	LOC_ADV
a tocateja	LOC_ADV
a toda brida	LOC_ADV
a toda costa	LOC_ADV
a toda furia	LOC_ADV
a toda hostia	LOC_ADV
a toda leche	LOC_ADV
a toda ley	LOC_ADV
a toda máquina	LOC_ADV
a toda marcha	LOC_ADV
a toda mecha	LOC_ADV
a toda pastilla	LOC_ADV
a toda plana	LOC_ADV
a toda prisa	LOC_ADV
a toda rienda	LOC_ADV
a todas estas	LOC_ADV
a todas horas	LOC_ADV
a todo andar	LOC_ADV
a todo correr	LOC_ADV
a todo evento	LOC_ADV
a todo gas	LOC_ADV
a todo lo largo de	LOC_PREP
a todo lo largo	LOC_ADV
a todo meter	LOC_ADV
a todo moler	LOC_ADV
a todo pasto	LOC_ADV
a todo riesgo	LOC_ADV
a todo ruedo	LOC_ADV
a todo tirar	LOC_ADV
a todo trance	LOC_ADV
a todo vapor	LOC_ADV
a tontas y a locas	LOC_ADV
a topa tolondro	LOC_ADV
a tope	LOC_ADV
a toque de campana	LOC_ADV
a torna peón	LOC_ADV
a torna punta	LOC_ADV
a torno	LOC_ADV
a traición	LOC_ADV
a trancas y barrancas	LOC_ADV
a trancos	LOC_ADV
a traque barraque	LOC_ADV
a través de	LOC_PREP
a troche y moche	LOC_ADV
a trompa y talega	LOC_ADV
a trompicones	LOC_ADV
a tropezones	LOC_ADV
a trueco de	LOC_PREP
a trueque	LOC_ADV
atta.	Y
atte.	Y
atto.	Y
a tuertas	LOC_ADV
a tuertas o a derechas	LOC_ADV
a tuerto o a derecho	LOC_ADV
a tutiplén	LOC_ADV
A. T.	Y
audición y lenguaje	NCFS000
audiencia nacional	NCFS000
audiencia provincial	NCFS000
auditoría de cuentas	NCFS000
auditoría externo	NCFS000
auditoría interno	NCFS000
aula de informática	NCFS000
a ultranza	LOC_ADV
aumento de precio	NCMS000
aún así	LOC_ADV
aún con eso	LOC_ADV
aún cuando	LOC_ADV
a un lado de	LOC_PREP
a un lado y otro	LOC_ADV
a uno y otro lado	LOC_ADV
a un solo efecto	LOC_ADV
a upa	LOC_ADV
aurea mediocritas	LOC_ADV
a usanza de	LOC_PREP
automóvil club	NCMS000
autonomía personal	NCFS000
# autoridad laboral	LOC_NC
autorización expresa	NCFS000
autorización judicial	NCFS000
autorización previa	NCFS000
avda.	Y
avd.	Y
a veces	LOC_ADV
a vez que	LOC_CS
a vida o muerte	LOC_ADV
a vista de pájaro	LOC_ADV
a viva voz	LOC_ADV
a voz en cuello	LOC_ADV
a voz en grito	LOC_ADV
a vuela pluma	LOC_ADV
a vuelapluma	LOC_ADV
a vuelco de dado	LOC_ADV
a vuelta de correo	LOC_ADV
a vuelta de	LOC_PREP
a vuelta de ojo	LOC_ADV
a vuelta de ojos	LOC_ADV
a.	Y
a. C.	Y
A. D.	Y
a. de C.	Y
a. de J. C.	Y
A. I.	Y
a. J. C.	Y
a. m.	Y
A. M. D. G.	Y
A. R.	Y
A. S.	Y
A. T.	Y
A/A	Y
a/c	Y
a/f	Y
AA. VV.	Y
aa. vv.	Y
ab aeterno	LOC_ADV
ab initio	LOC_ADV
ab intestato	LOC_ADV
ab irato	LOC_ADV
ab ovo	LOC_ADV
Abg.	Y
acept.	Y
acerca de	LOC_PREP
ad calendas graecas	LOC_ADV
ad cautelam	LOC_ADV
ad efesios	LOC_ADV
ad hoc	LOC_ADV
ad hominem	LOC_ADV
ad honorem	LOC_ADV
ad infinitum	LOC_ADV
ad interim	LOC_ADV
ad lib	LOC_ADV
ad libitum	LOC_ADV
ad litem	LOC_ADV
ad litteram	LOC_ADV
ad quadrantum	LOC_ADV
ad triangulum	LOC_ADV
ad valorem	LOC_ADV
además de	LOC_PREP
además de eso	LOC_ADV
además de que	LOC_CS
adm.	Y
admón.	Y
afma.	Y
afmo.	Y
Agnus Dei	NCMS000
ahora bien	LOC_ADV
ahí es nada	LOC_ADV
ahí le duele	LOC_ADV
al abrigo de	LOC_PREP
al alcance de la mano	LOC_ADV
al alimón	LOC_ADV
al apa	LOC_ADV
al avemaría	LOC_ADV
al bies	LOC_ADV
al cabo de	LOC_PREP
al calor de	LOC_PREP
al carboncillo	LOC_ADV
al cargo de	LOC_PREP
al centro de	LOC_PREP
al chas chas	LOC_ADV
al cien por cien	LOC_ADV
al cierre del ejercicio	LOC_ADV
al clarear el día	LOC_ADV
al compás de	LOC_PREP
al conjuro de	LOC_PREP
al correr de la pluma	LOC_ADV
al correr del tiempo	LOC_ADV
al decir de	LOC_PREP
al derredor	LOC_ADV
al derredor de	LOC_PREP
al desbarate	LOC_ADV
al descuido y con cuidado	LOC_ADV
al desgaire	LOC_ADV
al detall	LOC_ADV
al estricote	LOC_ADV
al filo de	LOC_PREP
al filo de mediodía	LOC_ADV
al fin de la jornada	LOC_ADV
al fin y a la postre	LOC_ADV
al fin y al cabo	LOC_ADV
al frente de	LOC_PREP
al gratén	LOC_ADV
al grill	LOC_ADV
al gusto de	LOC_PREP
al hilo	LOC_ADV
al hilo de mediodía	LOC_ADV
al hilo del viento	LOC_ADV
al igual que	LOC_CS
al interior de	LOC_PREP
al libre albedrío	LOC_ADV
al lucero del alba	LOC_ADV
al mejor tiempo	LOC_ADV
al modo de	LOC_PREP
al objeto de	LOC_PREP
al olor de	LOC_PREP
al otro lado de	LOC_PREP
al par	LOC_ADV
al par que	LOC_CS
al paso que	LOC_CS
al paño	LOC_ADV
al pie de fábrica	LOC_ADV
al pie de la cuesta	LOC_ADV
al pie de la letra	LOC_ADV
al pie de la obra	LOC_ADV
al poco rato	LOC_ADV
al por mayor	LOC_ADV
al por menor	LOC_ADV
al primer envite	LOC_ADV
al primer folio	LOC_ADV
al primer gallo	LOC_ADV
al primer golpe de vista	LOC_ADV
al primer impulso	LOC_ADV
al proviso	LOC_ADV
al punto que	LOC_CS
al rape	LOC_ADV
al raso	LOC_ADV
al rededor	LOC_ADV
al retortero	LOC_ADV
al rojo blanco	LOC_ADV
al rojo cereza	LOC_ADV
al sesgo	LOC_ADV
al socaire	LOC_ADV
al socaire de	LOC_PREP
al tanto de	LOC_PREP
al temple	LOC_ADV
al tendido	LOC_ADV
al tenor de	LOC_PREP
al tiempo que	LOC_CS
al tresbolillo	LOC_ADV
al volateo	LOC_ADV
alea iacta est	LOC_ADV
Alfz.	Y
alguna que otra vez	LOC_ADV
algunas veces	LOC_ADV
alguno que otro	LOC_ADV
allende de	LOC_PREP
allá se andan	LOC_ADV
allá se las avenga	LOC_ADV
allá se las componga	LOC_ADV
allá se las haya	LOC_ADV
allá se las hayan	LOC_ADV
allá se van	LOC_ADV
alma mater	NCFS000
Almte.	Y
alter ego	NCMN000
ante diem	LOC_ADV
ante meridiem	LOC_ADV
anterior a	LOC_PREP
antes bien	LOC_ADV
antes pues	LOC_ADV
antes que nada	LOC_ADV
ap.	Y
aparte de	LOC_PREP
apdo.	Y
aprox.	Y
arate cavate	LOC_ADV
ares y mares	LOC_ADV
Arq.	Y
arroz abanda	NCMS000
art déco	AQ0CN0
art deco	AQ0CN0
art decó	AQ0CN0
Art Déco	AQ0CN0
Art Deco	AQ0CN0
Art Decó	AQ0CN0
art nouveau	AQ0CN0
Art Nouveau	AQ0CN0
Art Brut	AQ0CN0
art brut	AQ0CN0
art.	Y
art.º	Y
Arz.	Y
Ayto.	Y
así como también	LOC_ADV
así como tampoco	LOC_ADV
así pues	LOC_ADV
así y todo	LOC_ADV
atta.	Y
atte.	Y
atto.	Y
aurea mediocritas	LOC_ADV
av.	Y
avd.	Y
avda.	Y
ayer noche	LOC_ADV
ayuda a domicilio	NCFS000
ayuda humanitaria	NCFS000
ayuda oficial	NCFS000
bajo cuerda	LOC_ADV
bajo el poder de	LOC_PREP
bajo juramento	LOC_ADV
bajo la responsabilidad de	LOC_PREP
bajo llave	LOC_ADV
bajo mano	LOC_ADV
bajo ningún concepto	LOC_ADV
bajo siete llaves	LOC_ADV
banco bilbao vizcaya argentaria	NCMS000
banco central europeo	NCMS000
banco de pruebas	NCMS000
banco de sangre	NCMS000
banco mundial	NCMS000
banco nacional	NCMS000
banco santander central hispano	NCMS000
banda ancha	NCFS000
bandera nacional	NCFS000
bandera roja	NCFS000
Barna.	Y
base de cálculo	NCFS000
base jurídica	NCFS000
Bco.	Y
bel canto	NCMS000
belle époque	NCFS000
best seller	NCMN000
biblioteca pública	NCFS000
Bibl.	Y
# bien de capital	LOC_NC
bien entendido que	LOC_CS
bienestar social	NCMS000
bien mirado	LOC_ADV
# bien patrimonial	LOC_NC
# bien público	LOC_NC
bien que mal	LOC_ADV
bien sabe Dios que	LOC_CS
big band	NCMS000
big bands	NCMP000
big bang	NCMS000
Big Bang	NCMS000
biología molecular	NCMS000
bioquímica clínica	NCMS000
black jack	NCMS000
b. l. m.	Y
bloqueo económico	NCMS000
blue jean	NCMS000
blue jeans	NCMP000
Bma.	Y
Bmo.	Y
bóbilis bóbilis	LOC_ADV
boca arriba	LOC_ADV
boletín oficial del estado	NCMS000
boletín oficial de navarra	NCMS000
bolsa de comercio	NCFS000
bolsa de plástico	NCFS000
# bosque tropical	LOC_NC
B.º	Y
Bo.	Y
boy scout	NCMS000
boy scouts	NCMP000
Boy Scout	NCMS000
Boy Scouts	NCMP000
break dance	NCMS000
Brig.	Y
Brutus Brutus	NPCNSP0
Bs. As.	Y
Bta.	Y
Bto.	Y
Buenos Aires	NPCSG00
Burkina Faso	NPCSG00
# buzón de correo electrónico	LOC_NC
# buzón de correo	LOC_NC
B.	Y
cada cosa por su lado	LOC_ADV
cada dos por tres	LOC_ADV
cada quisque	NCMS000
cadena de producción	NCFS000
cadena de tiendas	NCFS000
caja de herramientas	NCFS000
caj.	Y
calamo currente	LOC_ADV
cálamo currente	LOC_ADV
calidad asistencial	NCFS000
calidad del agua	NCFS000
calidad de vida	NCFS000
cámara alta	NCFS000
cámara baja	NCFS000
cámara de representantes	NCFS000
cámara web	NCFS000
cambio climático	NCMS000
cambio de gobierno	NCMS000
cambio de uso	NCMS000
campaña de promoción	NCFS000
campaña electoral	NCFS000
campaña política	NCFS000
campeonato mundial	NCMS000
campeonato nacional	NCMS000
# campeón mundial	LOC_NC
campo de aplicación	NCMS000
campo de fútbol	NCMS000
campo de golf	NCMS000
campo de juego	NCMS000
campo eléctrico	NCMS000
campo magnético	NCMS000
# campus universitario	LOC_NC
canción de amor	NCFS000
cantidad de energía	NCFS000
cantidad de información	NCFS000
capacidad creativa	NCFS000
capacidad de aprendizaje	NCFS000
capacidad de obrar	NCFS000
capacidad jurídica	NCFS000
capacidad legal	NCFS000
capacidad operativa	NCFS000
Cap. Fed.	Y
capin melao	LOC_ADV
capital de riesgo	NCFS000
capital humano	NCFS000
capital riesgo	NCFS000
cap.º	Y
captura de datos	NCFS000
Cap.	Y
cap.	Y
cara abajo	LOC_ADV
cara a cara	LOC_ADV
cara arriba	LOC_ADV
carga de trabajo	NCFS000
carga eléctrica	NCFS000
# carnet de conducir	LOC_NC
carpe diem	LOC_ADV
carta apostólica	NCFS000
carta certificada	NCFS000
carta de las naciones unidas	NCFS000
carta magna	NCFS000
cartera de clientes	NCFS000
cartera de valores	NCFS000
casa museo	NCFS000
casa rural	NCFS000
casas museo	NCFP000
casi geostrófico	LOC_ADV
casi que	LOC_CS
Cástor y Pólux	LOC_ADV
casus belli	LOC_ADV
C. A.	Y
C.ª	Y
c/c	Y
C. C.	Y
c. c.	Y
Cdad.	Y
celebración eucarística	NCFS000
censo de población	NCMS000
centímetro cuadrado	NCMS000
centímetro cúbico Fh segundo	NCMS000
centímetro cúbico	NCMS000
centímetro cúbico por segundo	NCMS000
centímetro de hg	NCMS000
centímetro de mercurio	NCMS000
centímetro Fh segundo	NCMS000
centímetro Fh s	NCMS000
centímetro por segundo	NCMS000
centímetro segundo	NCMS000
central hidroeléctrica	NCFS000
central nuclear	NCFS000
central térmica	NCFS000
centro asistencial	NCMS000
centro cívico	NCMS000
centro de atención al cliente	NCMS000
centro de día	NCMS000
centro de documentación	NCMS000
centro de gestión	NCMS000
centro de rehabilitación	NCMS000
centro escolar	NCMS000
centro hospitalario	NCMS000
centro penitenciario	NCMS000
cent.	Y
cént.	Y
cepillo de dientes	NCMS000
ceremonia de clausura	NCFS000
certificado de asistencia	NCMS000
certificado de estudios	NCMS000
certificado de nacimiento	NCMS000
c. e.	Y
cfr.	Y
c. f. s.	Y
C. F.	Y
cf.	Y
cgo.	Y
chaise longue	NCFS000
# cheque certificado	LOC_NC
chill out	NCMS000
chino mandarín	NCMS000
chorro de agua	NCMS000
ch/	Y
Cía.	Y
ciclo económico	NCMS000
ciclo formativo	NCMS000
ciclo vital	NCMS000
ciencia biológica	NCFS000
ciencia de la educación	NCFS000
ciencia de la naturaleza	NCFS000
ciencia empresarial	NCFS000
cien por cien	LOC_ADV
ciento por ciento	LOC_ADV
ciento y la madre	LOC_ADV
cifra de negocio	NCFS000
cine de terror	NCMS000
cine documental	NCMS000
cine erótico	NCMS000
cine fantástico	NCMS000
cinta adhesiva	NCFS000
circuito cerrado	NCMS000
circulación sanguínea	NCFS000
cirugía torácica	NCFS000
cirugía vascular	NCFS000
C. I.	Y
cje.	Y
clase obrera	NCFS000
clase política	NCFS000
clase social	NCFS000
clase trabajadora	NCFS000
claustro de profesores	NCMS000
# clave de acceso	LOC_NC
clima mediterráneo	NCMS000
clima templado	NCMS000
clima tropical	NCMS000
cl.	Y
cm3 Fh seg	NCFS000
cm3 Fh s	NCFS000
Cmdt.	Y
cm Fh s	NCFS000
Cmte.	Y
Cnel.	Y
cochite hervite	LOC_ADV
código de comercio	NCMS000
código de identificación	NCMS000
código ético	NCMS000
código fuente	NCMS000
código genético	NCMS000
codo a codo	LOC_ADV
codo con codo	LOC_ADV
cód.	Y
coitus interruptus	NCMN000
colección privada	NCFS000
colegio de abogados	NCMS000
colegio nacional	NCMS000
colegio público	NCMS000
Col.	Y
col.	Y
comandante en jefe	NCCS000
comercio bilateral	NCMS000
comercio justo	NCMS000
comisión asesora	NCFS000
comisión de evaluación	NCFS000
comisión de gobierno	NCFS000
comisión económica	NCFS000
comisión ejecutiva	NCFS000
comisiones obreras	NCFP000
comisión europea	NCFS000
comisión mixta	NCFS000
comisión nacional del mercado de valores	NCFS000
comisión negociadora	NCFS000
comisión paritaria	NCFS000
comisión parlamentaria	NCFS000
comité central del partido	NCMS000
comité económico y social	NCMS000
comité ejecutivo	NCMS000
comité olímpico internacional	NCMS000
comité organizador	NCMS000
como ahora es de día	LOC_ADV
como alma que lleva el diablo	LOC_ADV
como a los ojos de su cara	LOC_ADV
como a real de enemigo	LOC_ADV
como caído de las nubes	LOC_ADV
como de la noche al día	LOC_ADV
como dos y dos son cuatro	LOC_ADV
Comod.	Y
como el convidado de piedra	LOC_ADV
como el día a la noche	LOC_ADV
como el perro y el gato	LOC_ADV
como es debido	LOC_ADV
como es de día	LOC_ADV
como está mandado	LOC_ADV
como estamos aquí tú y yo	LOC_ADV
como hay Dios	LOC_ADV
como hecho de encargo	LOC_ADV
como la palma de la mano	LOC_ADV
como los chorros del oro	LOC_ADV
como mínimo	LOC_ADV
como mucho	LOC_ADV
como oro en paño	LOC_ADV
como Pedro por su casa	LOC_ADV
como por ensalmo	LOC_ADV
como que	LOC_CS
como quien dice	LOC_ADV
como quien no quiere la cosa	LOC_ADV
como quien oye llover	LOC_ADV
como quiera que	LOC_CS
como si no hubiera dicho nada	LOC_ADV
como si tal cosa	LOC_ADV
como un pepe	LOC_ADV
compact disc	NCMS000
compañero de equipo	NCMS000
compañía aérea	NCFS000
compañía de jesús	NCFS000
compensación económica	NCFS000
complejo turístico	NCMS000
comportamiento humano	NCMS000
comportamiento sexual	NCMS000
comportamiento social	NCMS000
composición musical	NCFS000
comprensión lectora	NCFS000
compromiso político	NCMS000
Comp.	Y
Comte.	Y
comunicación de datos	NCFS000
comunicación oral	NCFS000
comunicación verbal	NCFS000
comunidad económica europea	NCFS000
comunidad europea	NCFS000
# comunidad humana	LOC_NC
con carácter de	LOC_PREP
concesión administrativa	NCFS000
conciencia colectiva	NCFS000
conciencia nacional	NCFS000
conciencia pública	NCFS000
conciencia social	NCFS000
concilio vaticano II	NCMN000
con claridad meridiana	LOC_ADV
con conocimiento de causa	LOC_ADV
con creces	LOC_ADV
condiciones ambientales	NCFP000
condiciones atmosféricas	NCFP000
condiciones de venta	NCFP000
condiciones de vida	NCFP000
condiciones económicas	NCFP000
condiciones generales	NCFP000
conducta humana	NCFS000
con efecto desde	LOC_PREP
con el culo al aire	LOC_ADV
con el ojo tan largo	LOC_ADV
con el sudor de la frente	LOC_ADV
con excepción de	LOC_PREP
conexión a la red	NCFS000
conferencia episcopal	NCFS000
conferencia mundial	NCFS000
conflicto armado	NCMS000
conflicto social	NCMS000
conforme a	LOC_PREP
cónfr.	Y
cónf.	Y
congregación para la doctrina de la fe	NCMN000
congreso eucarístico	NCMS000
congreso nacional	NCMS000
con honores de	LOC_PREP
con la ayuda de Dios	LOC_ADV
con la boca abierta	LOC_ADV
con la casa a cuestas	LOC_ADV
con la condición de	LOC_PREP
con la espada desnuda	LOC_ADV
con la frente alta	LOC_ADV
con la frente bien alta	LOC_ADV
con la frente levantada	LOC_ADV
con la lengua de un palmo	LOC_ADV
con la lengua fuera	LOC_ADV
con la mano en el corazón	LOC_ADV
con la música a otra parte	LOC_ADV
con las manos cruzadas	LOC_ADV
con las manos vacías	LOC_ADV
con la soga al cuello	LOC_ADV
con las orejas caídas	LOC_ADV
con las orejas gachas	LOC_ADV
con las orejas tan largas	LOC_ADV
con las piernas cruzadas	LOC_ADV
con la vida en un hilo	LOC_ADV
con lo que respecta a	LOC_PREP
con los cinco sentidos	LOC_ADV
con los ojos cerrados	LOC_ADV
con los pies delante	LOC_ADV
con mala idea	LOC_ADV
con mal pie	LOC_ADV
con mano escasa	LOC_ADV
con mano pesada	LOC_ADV
con mil amores	LOC_ADV
con miquis	LOC_ADV
con miras a	LOC_PREP
con moto	LOC_ADV
con mucho gusto	LOC_ADV
con objeto de	LOC_PREP
con objeto que	LOC_CS
con ocasión de	LOC_PREP
conocimiento científico	NCMS000
conocimiento humano	NCMS000
con pelos y señales	LOC_ADV
con pies de plomo	LOC_ADV
con puntos y comas	LOC_ADV
con relación a	LOC_PREP
con respecto a	LOC_PREP
con respecto de	LOC_PREP
consecutio temporum	LOC_ADV
consejo de estado	NCMS000
consejo de europa	NCMS000
consejo de la unión europea	NCMS000
consejo de ministros	NCMS000
consejo de seguridad de las naciones unidas	NCMS000
consejo de seguridad	NCMS000
consejo directivo	NCMS000
consejo económico y social	NCMS000
consejo ejecutivo	NCMS000
consejo municipal	NCMS000
consejo nacional	NCMS000
consejo permanente	NCMS000
conservatorio de música	NCMS000
con solo que	LOC_CS
con sordina	LOC_ADV
construcción naval	NCFS000
consulta popular	NCFS000
contabilidad financiera	NCFS000
con tal de	LOC_PREP
con tal de que	LOC_CS
con tal que	LOC_CS
contaminación acústica	NCFS000
contaminación ambiental	NCFS000
contaminación atmosférica	NCFS000
contaminación del agua	NCFS000
con toda la barba	LOC_ADV
con toda la boca	LOC_ADV
con toda normalidad	LOC_ADV
con todas las de la ley	LOC_ADV
con todo y con eso	LOC_ADV
contradictio in terminis	NCFS000
Contralmte.	Y
contra reloj	LOC_ADV
contra rembolso	LOC_ADV
contratación de personal	NCFS000
contrato de obra	NCMS000
contrato social	NCMS000
contra viento y marea	LOC_ADV
control de flujo	NCMS000
control de gestión	NCMS000
# control médico	LOC_NC
control numérico	NCMS000
con uñas y dientes	LOC_ADV
con un palmo de lengua	LOC_ADV
con valor de	LOC_PREP
convención de ginebra	NCMS000
convención europea	NCFS000
con viento fresco	LOC_ADV
con vistas a	LOC_PREP
con zurrapas	LOC_ADV
cooperación económica	NCFS000
coord.ª	Y
coordenadas geográficas	NCFS000
coord.	Y
copa de europa	NCFS000
copa intercontinental	NCFS000
coram populo	LOC_ADV
córam pópulo	LOC_ADV
corpore insepulto	LOC_ADV
correlación de fuerzas	NCFS000
correo basura	NCFS000
correo no deseado	NCFS000
corriente y moliente	AQ0CS0
cortes generales	NCFP000
corte suprema	NCFS000
corteza cerebral	NCFS000
cosa juzgada	NCFS000
C. por A.	Y
C. P.	Y
cp.	Y
crecimiento de la población	NCMS000
crecimiento urbano	NCMS000
crec.	Y
crédito personal	NCMS000
# crisis económica	LOC_NC
cruz roja internacional	NCFS000
cruz roja	NCFS000
cta. cte.	Y
cta.	Y
Cte.	Y
cts.	Y
ctvo.	Y
ctv.	Y
cuanto antes	LOC_ADV
cubierta vegetal	NCFS000
cuello uterino	NCMS000
cuenta de ahorro	NCFS000
cuenta de pérdidas y ganancias	NCFS000
cuenta de resultados	NCFS000
cuerpo de bomberos	NCMS000
cuerpo diplomático	NCMS000
cuerpo docente	NCMS000
cuerpo legislativo	NCMS000
cuidado médico	NCMS000
cultura clásica	NCFS000
cum laude	LOC_ADJ
cum laude	LOC_ADV
cum laude	LOC_AQ0CN0
curriculum vitae	LOC_ADV
curriculum vitae	NCMN000
curso académico	NCMS000
curso intensivo	NCMS000
c/u	Y
c/	Y
c.	Y
da capo	LOC_ADV
dado que	LOC_CS
dalái lama	NPMNSP0
daño cerebral	NCMS000
daño material	NCMS000
darse de alta	LOC_ADV
dato económico	NCMS000
dato personal	NCMS000
# datos bancario	LOC_NC
D.ª	Y
dcha.	Y
dcho.	Y
d. C.	Y
d. de C.	Y
d. de J. C.	Y
de acá para allá	LOC_ADV
de acarreo	LOC_ADV
de acuerdo con	LOC_PREP
de a folio	LOC_ADV
de ahí que	LOC_CS
de al lado de	LOC_PREP
de alto copete	LOC_ADV
de alto coturno	LOC_ADV
de altos vuelos	LOC_ADV
#de amplio espectro	LOC_ADJ
de andar por casa	LOC_ADV
de anequín	LOC_ADV
de antemano	LOC_ADV
de aquí en adelante	LOC_ADV
de aquí para allí	LOC_ADV
de aquí que	LOC_CS
de armas tomar	LOC_ADV
de arrastre	LOC_ADV
de arte mayor	LOC_ADV
de arte menor	LOC_ADV
de aúpa	LOC_ADV
de a veras	LOC_ADV
de baja estofa	LOC_ADV
debajo de	LOC_PREP
de bajo vuelo	LOC_ADV
de balde	LOC_ADV
de ballesta	LOC_ADV
de barra a barra	LOC_ADV
# debate parlamentario	LOC_NC
# debido a	LOC_PREP
de bóbilis	LOC_ADV
de boca en boca	LOC_ADV
de bote en bote	LOC_ADV
de bracero	LOC_ADV
de bruces	LOC_ADV
de buena cepa	LOC_ADV
de buena familia	LOC_ADV
de buena fe	LOC_ADV
de buena gana	LOC_ADV
de buena ley	LOC_ADV
de buena ropa	LOC_ADV
de buenas a primeras	LOC_ADV
de buena voluntad	LOC_ADV
de buen efecto	LOC_ADV
de buen grado	LOC_ADV
de buen tono	LOC_ADV
de bureo	LOC_ADV
de cabo a rabo	LOC_ADV
de canto	LOC_ADV
de cañutillo	LOC_ADV
de cara a	LOC_PREP
de carrerilla	LOC_ADV
de carretilla	LOC_ADV
de cascabel gordo	LOC_ADV
de casquería	LOC_ADV
de chipén	LOC_ADV
de churro	LOC_ADV
de ciencia cierta	LOC_ADV
de circunvalación	LOC_ADV
declaración de guerra	NCFS000
declaración de principios	NCFS000
declaración jurada	NCFS000
de coña	LOC_ADV
de consuno	LOC_ADV
de corredera	LOC_ADV
de cortos vuelos	LOC_ADV
decreto ley	NCMS000
decreto ley	NCMS000
decretos leyes	NCMS000
de cuajo	LOC_ADV
de cualquier forma	LOC_ADV
de cuando en cuando	LOC_ADV
de cuelga	LOC_ADV
de cuenta y riesgo	LOC_ADV
de cuerpo presente	LOC_ADV
de cutio	LOC_ADV
de debajo de	LOC_PREP
de delante de	LOC_PREP
de dentro de	LOC_PREP
de detrás de	LOC_PREP
de día en día	LOC_ADV
de dientes afuera	LOC_ADV
de Dios abajo	LOC_ADV
de disparo	LOC_ADV
de doble filo	LOC_ADV
de dos en dos	LOC_ADV
de dos filos	LOC_ADV
de ensueño	LOC_ADV
de entonces acá	LOC_ADV
de entreguerras	LOC_ADJ
de estampía	LOC_ADV
de este lado de	LOC_PREP
de extranjis	LOC_ADV
de facto	LOC_ADV
de falondres	LOC_ADV
de fogueo	LOC_ADV
de fuera de	LOC_PREP
de golpe y porrazo	LOC_ADV
de grado en grado	LOC_ADV
de guagua	LOC_ADV
de guardarropía	LOC_ADV
de guillotina	LOC_ADV
de higos a brevas	LOC_ADV
de hoy en adelante	LOC_ADV
de hoy para mañana	LOC_ADV
de hoz y de coz	LOC_ADV
de ida y vuelta	LOC_ADV
de iure	LOC_ADV
de jure	LOC_ADV
de juro	LOC_ADV
de la cruz a la fecha	LOC_ADV
de lado a lado	LOC_ADV
de la mano de	LOC_PREP
de lance en lance	LOC_ADV
de la noche a la mañana	LOC_ADV
delante de Dios y de todo el	LOC_ADV
delante de	LOC_PREP
de la puñeta	LOC_ADV
de la zona de	LOC_PREP
delegación territorial	NCFS000
de lengua en lengua	LOC_ADV
delirium tremens	NCMN000
delito doloso	NCMS000
de lo contrario	LOC_ADV
de lo lindo	LOC_ADV
del otro lado de	LOC_PREP
del otro lado	LOC_ADV
de lo vivo a lo pintado	LOC_ADV
del poder de	LOC_PREP
del primer voleo	LOC_ADV
del principio al fin	LOC_ADV
del revés	LOC_ADV
del tiempo de Maricastaña	LOC_ADJ
del tiempo de Maricastaña	LOC_ADV
del.	Y
de madrugada	LOC_ADV
de mal abrigo	LOC_ADV
de mala fe	LOC_ADV
de mala gana	LOC_ADV
de mala ley	LOC_ADV
de mal a mal	LOC_ADV
de mala manera	LOC_ADV
de mala muerte	LOC_ADV
de mala nota	LOC_ADV
de mal efecto	LOC_ADV
de mal en peor	LOC_ADV
de mal grado	LOC_ADV
de mal tono	LOC_ADV
de mal vivir	LOC_ADV
de mancomún	LOC_ADV
demanda agregada	NCFS000
demanda de empleo	NCFS000
# demandante de empleo	LOC_NC
de mano derecha	LOC_ADV
de mano en mano	LOC_ADV
de mano izquierda	LOC_ADV
de manos a boca	LOC_ADV
de marca mayor	LOC_ADV
de marras	LOC_ADV
de más marca	LOC_ADV
de matute	LOC_ADV
de media gala	LOC_ADV
de medio a medio	LOC_ADV
de medio lado	LOC_ADV
de medio ojo	LOC_ADV
de medio pie	LOC_ADV
de mentirijillas	LOC_ADV
de mil amores	LOC_ADV
de mil diablos	LOC_ADV
de mírame y no me toques	LOC_ADV
de miranda	LOC_ADV
de misa y olla	LOC_ADV
democracia participativa	NCFS000
de modo que	LOC_CS
de momio	LOC_ADV
de morondanga	LOC_ADV
de muchas campanillas	LOC_ADV
de muchas leguas	LOC_ADV
de mucho efecto	LOC_ADV
de mucho trote	LOC_ADV
de ninguna manera	LOC_ADV
denominación social	NCFS000
de nueva planta	LOC_ADV
de nuevo cuño	LOC_ADV
de nunca acabar	LOC_ADV
deo gracias	I
deo gracias	LOC_ADV
deo gracias	LOC_I
de oídas	LOC_ADV
de oque	LOC_ADV
de órdago	LOC_ADV
de oreja a oreja	LOC_ADV
de oro y azul	LOC_ADV
deo volente	LOC_ADV
Deo volente	LOC_ADV
de pacotilla	LOC_ADV
de padre y muy señor mío	LOC_ADV
de palabra en palabra	LOC_ADV
departamento de agricultura	NCMS000
departamento de educación	NCMS000
departamento de industria , comercio y turismo	NCMS000
departamento de justicia	NCMS000
departamento de medio ambiente	NCMS000
de pascuas a ramos	LOC_ADV
de pe a pa	LOC_ADV
de pega	LOC_ADV
de pelo en pecho	LOC_ADV
dependencia económica	NCFS000
de perdidos al río	LOC_ADV
de perilla	LOC_ADV
de perillas	LOC_ADV
de persona a persona	LOC_ADV
de pie de banco	LOC_ADV
de pies a cabeza	LOC_ADV
de pilón	LOC_ADV
de pitiminí	LOC_ADV
de pleno derecho	LOC_ADV
de poca monta	LOC_ADV
de poca ropa	LOC_ADV
de poco más o menos	LOC_ADV
de poco pelo	LOC_ADV
de poder a poder	LOC_ADV
de polo a polo	LOC_ADV
de pontifical	LOC_ADV
de popa a proa	LOC_ADV
de por junto	LOC_ADV
de por medio	LOC_ADV
de por sí	LOC_ADV
# deporte de aventura	LOC_NC
deporte profesional	NCMS000
de por vida	LOC_ADV
de postín	LOC_ADV
de potencia en potencia	LOC_ADV
de primera clase	LOC_ADV
de primera intención	LOC_ADV
de primera línea	LOC_ADV
de prisa	LOC_ADV
de prisa y corriendo	LOC_ADV
de profundis	LOC_ADV
de pro	LOC_ADV
de propia minerva	LOC_ADV
de propio puño	LOC_ADV
depto.	Y
de puerta a puerta	LOC_ADV
de puerta en puerta	LOC_ADV
de puertas adentro	LOC_ADV
de puertas afuera	LOC_ADV
de puertos allende	LOC_ADV
de puertos aquende	LOC_ADV
de puño y letra	LOC_ADV
de punta a cabo	LOC_ADV
de punta a punta	LOC_ADV
de pura cepa	LOC_ADV
depuración de aguas	NCMS000
depuración de aguas residuales	NCMS000
de puta madre	LOC_ADV
de puta pena	LOC_ADV
de putifa	LOC_ADV
D. E. P.	Y
de quedo	LOC_ADV
de quita y pon	LOC_ADV
de rama en rama	LOC_ADV
de raro en raro	LOC_ADV
de rato en rato	LOC_ADV
de rebato	LOC_ADV
de rebote	LOC_ADV
derecho adquirido	NCMS000
derecho a participar	NCMS000
derecho civil	NCMS000
derecho de asociación	NCMS000
derecho de autodeterminación	NCMS000
derecho de familia	NCMS000
derecho de huelga	NCMS000
derecho del hombre	NCMS000
derecho de petición	NCMS000
derecho de uso	NCMS000
derecho de voto	NCMS000
derecho fiscal	NCMS000
derecho fundamental	NCMS000
derecho humano	NCMS000
derecho individual	NCMS000
derecho nacional	NCMS000
derecho natural	NCMS000
derecho político	NCMS000
derecho positivo	NCMS000
derecho privado	NCMS000
derecho público	NCMS000
derecho subjetivo	NCMS000
derecho tributario	NCMS000
de rechupete	LOC_ADV
de refilón	LOC_ADV
de relumbrón	LOC_ADV
de reojo	LOC_ADV
de repelón	LOC_ADV
de repente	LOC_ADV
de repuesto	LOC_ADV
de reserva	LOC_ADV
de resultas	LOC_ADV
de retrocarga	LOC_ADV
de revuelo	LOC_ADV
de rodilla en rodilla	LOC_ADV
de rompe y rasga	LOC_ADV
de rondón	LOC_ADV
desarrollo de la personalidad	NCMS000
desarrollo económico	NCMS000
desarrollo rural	NCMS000
desarrollo urbano	NCMS000
desastre ecológico	NCMS000
desastre natural	NCMS000
descarga eléctrica	NCFS000
desct.º	Y
desde cero	LOC_ADV
desde el momento en que	LOC_CS
desde luego	LOC_ADV
desde niño	LOC_ADV
desde que el mundo es mundo	LOC_ADV
de seguida	LOC_ADV
de segunda mano	LOC_ADV
de sentido común	LOC_ADV
de sobra	LOC_ADV
de sobresalto	LOC_ADV
de so capa	LOC_ADV
de sol a sol	LOC_ADV
de soslayo	LOC_ADV
de suerte que	LOC_CS
de tal manera que	LOC_CS
de tapadillo	LOC_ADV
de tarde en tarde	LOC_ADV
de tiempo en tiempo	LOC_ADV
de tiento en tiento	LOC_ADV
de todas maneras	LOC_ADV
de todas todas	LOC_ADV
de todo corazón	LOC_ADV
de todo en todo	LOC_ADV
de todo punto	LOC_ADV
de todos los diablos	LOC_ADV
de todos modos	LOC_ADV
detrás de	LOC_PREP
de través	LOC_ADV
de trazo continuo	LOC_ADV
de trecho en trecho	LOC_ADV
de tres al cuarto	LOC_ADV
de tú a tú	LOC_ADV
de ultratumba	LOC_ADV
de una manera o de otra	LOC_ADV
de una sentada	LOC_ADV
de una tacada	LOC_ADV
de una tirada	LOC_ADV
de una vez para siempre	LOC_ADV
de un día a otro	LOC_ADV
de un jalón	LOC_ADV
de un lado a otro	LOC_ADV
de un lado para otro	LOC_ADV
de uno en uno	LOC_ADV
de un plumazo	LOC_ADV
de un primer voleo	LOC_ADV
de un tirón	LOC_ADV
deus ex machina	NCMN000
de uso externo	LOC_ADV
de uvas a peras	LOC_ADV
de vértigo	LOC_ADV
de vez en cuando	LOC_ADV
de vía estrecha	LOC_ADV
de visu	LOC_ADV
de viva voz	LOC_ADV
de volatería	LOC_ADV
d/f	Y
D. F.	Y
día de acción de gracias	NCMS000
día de descanso	NCFS000
día de fiesta	NCFS000
diagnóstico clínico	NCMS000
diagnóstico médico	NCMS000
diagnóstico precoz	NCMS000
diag.	Y
diario oficial de la unión europea	NCMS000
dibujo animado	NCMS000
dicc.	Y
dictadura militar	NCFS000
dies irae	NCMS000
dieta equilibrada	NCFS000
dietética y nutrición	NCMS000
dignidad humana	NCFS000
dióxido de azufre	NCFS000
dióxido de carbono	NCFS000
Dir.	NCMS000
Dir.ª	NCFS000
dirección administrativa	NCFS000
dirección a	LOC_PREP
dirección del viento	NCFS000
dirección de recursos humanos	NCFS000
dirección general de carreteras	NCFS000
dirección general de cultura	NCFS000
dirección general de los registros y del notariado	NCFS000
dirección general de seguros	NCFS000
dirección general de servicios	NCFS000
dirección general de tráfico	NCFS000
dirección general	NCFS000
dirección ip	NCFS000
dirección url	NCFS000
director adjunto	NCMS000
director administrativo	NCMS000
director artístico	NCMS000
director de fotografía	NCMS000
director de orquesta	NCMS000
director general	NCMS000
director gerente	NCMS000
directorio raíz	NCFS000
director técnico	NCMS000
Dir.	Y
disc jockey	NCFS000
diseño asistido por ordenador	NCMS000
diseño editorial	NCMS000
diseño industrial	NCMS000
disfunción eréctil	NCFS000
disposición legal	NCMS000
distribución espacial	NCFS000
distribución geográfica	NCFS000
distribución normal	NCFS000
distrito electoral	NCMS000
diversidad biológica	NCFS000
división de poderes	NCFS000
d. J. C.	Y
D. L.	Y
D. m.	Y
Dña.	Y
doble imposición	NCCS000
doble nacionalidad	NCCS000
# doctor en derecho	LOC_NC
documentación administrativa	NCFS000
documento de identidad	NCMS000
documento html	NCMS000
doc.	Y
# dolor de cabeza	LOC_NC
domiciliación bancaria	NCFS000
domicilio legal	NCMS000
domicilio social	NCMS000
dotación presupuestaria	NCFS000
do ut des	LOC_ADV
dpto.	Y
D. P.	Y
Dr.ª	NCFS000
droga ilícita	NCFS000
dto.	Y
dupdo.	Y
duración del contrato	NCFS000
duty free	LOC_ADJ
duty free	LOC_AQ0CN0
d/v	Y
D.	Y
Dña.	NCFS000
# eclipse total	LOC_NC
economía aplicada	NCFS000
economía de escala	NCFS000
economía de la salud	NCFS000
economía doméstica	NCFS000
economía española	NCFS000
economía familiar	NCFS000
economía general	NCFS000
economía informal	NCFS000
economía internacional	NCFS000
economía mixta	NCFS000
economía mundial	NCFS000
economía nacional	NCFS000
economía política	NCFS000
economía regional	NCFS000
economía social	NCFS000
e/c	Y
e. c.	Y
edad adulta	NCFS000
edad de jubilación	NCFS000
edad de oro	NCFS000
edad escolar	NCFS000
edad media	NCFS000
edición limitada	NCFS000
edificio central	NCMS000
edificio principal	NCMS000
edit.	Y
edo.	Y
educación ambiental	NCFS000
educación artística	NCFS000
educación de adultos	NCFS000
educación escolar	NCFS000
educación formal	NCFS000
educación general básica	NCFS000
educación infantil	NCFS000
educación infantil y primaria	NCFS000
educación intercultural	NCFS000
educación obligatoria	NCFS000
educación para el desarrollo	NCFS000
educación para la salud	NCFS000
educación preescolar	NCFS000
educación primaria	NCFS000
educación religiosa	NCFS000
educación sanitaria	NCFS000
educación secundaria	NCFS000
educación secundaria obligatoria	NCFS000
educación sexual	NCFS000
educación vial	NCFS000
ed.	Y
EE. UU.	NPMPG00
efecto directo	NCMS000
efecto especial	NCMS000
ef.	Y
ejecución de sentencia	NCFS000
# eje principal	LOC_NC
ejercicio económico	NCMS000
ejercicio físico	NCMS000
ejército de liberación	NCMS000
ejército de liberación nacional	NCMS000
ejército de tierra	NCMS000
ejército nacional	NCMS000
ejército popular	NCMS000
ejército zapatista de liberación nacional	NCMS000
eje y	NCMS000
ej.	Y
el acabose	NCMS000
elecciones al parlamento europeo	NCFP000
elecciones libres	NCFP000
elecciones parlamentarias	NCFP000
elección presidencial	NCFS000
El Escorial	NPMSG00
eliminación de residuos	NCFS000
Em.ª	Y
emergencia social	NCFS000
emisión de bonos	NCFS000
emisión de gases	NCFS000
Emmo.	Y
empleo estable	NCMS000
empresa comercial	NCFS000
empresa constructora	NCFS000
empresa de servicios	NCFS000
empresa de transporte	NCFS000
empresa estatal	NCFS000
empresa familiar	NCFS000
empresa industrial	NCFS000
empresa multinacional	NCFS000
empresa privada	NCFS000
empresa pública	NCFS000
en agraz	LOC_ADV
en aquel entonces	LOC_ADV
en aras de	LOC_PREP
en atención a	LOC_PREP
en babia	LOC_ADV
en batería	LOC_ADV
en berlina	LOC_ADV
en buena lid	LOC_ADV
en buenos términos	LOC_ADV
en busca de	LOC_PREP
en calidad de	LOC_PREP
en cambio de	LOC_PREP
en caso de	LOC_PREP
en caso de que	LOC_CS
encefalopatía espongiforme bovina	NCFS000
en cierto modo	LOC_ADV
encima de	LOC_PREP
en círculo	LOC_ADV
en compañía de	LOC_PREP
en compensación de	LOC_PREP
en coña	LOC_ADV
en concepto de	LOC_PREP
en consecuencia	LOC_ADV
en contorno	LOC_ADV
en contracambio	LOC_ADV
en contra de	LOC_PREP
en cuanto a	LOC_PREP
en cuanto que	LOC_CS
en cuclillas	LOC_ADV
en cuerpo y alma	LOC_ADV
encuesta de opinión	NCFS000
en cuestión de	LOC_PREP
en defecto de	LOC_PREP
en demanda de	LOC_PREP
en demasía	LOC_ADV
en derredor de	LOC_PREP
en derredor	LOC_ADV
en desbandada	LOC_ADV
en descargo	LOC_ADV
en desquite	LOC_ADV
en detalle	LOC_ADV
en diferido	LOC_ADV
en Dios y en conciencia	LOC_ADV
en dirección a	LOC_PREP
endocrinología y nutrición	NCFS000
en el centro de	LOC_PREP
en el entorno de	LOC_PREP
en el interior de	LOC_PREP
en el otro lado de	LOC_PREP
en el plazo de	LOC_PREP
en el puesto de	LOC_PREP
en el supuesto que	LOC_CS
en entredicho	LOC_ADV
energía eólica	NCFS000
energía térmica	NCFS000
en espera de	LOC_PREP
en este mismo instante	LOC_ADV
en evitación de	LOC_PREP
en favor de	LOC_PREP
enfermedad grave	NCFS000
enfermedad profesional	NCFS000
en fiado	LOC_ADV
en fila india	LOC_ADV
en fin de cuentas	LOC_ADV
en franquía	LOC_ADV
enfrente de	LOC_PREP
en gracia a	LOC_PREP
en gran manera	LOC_ADV
en gran medida	LOC_ADV
en guisa de	LOC_PREP
en honor a la verdad	LOC_ADV
en horre	LOC_ADV
en interés	LOC_ADV
en jamás de los jamases	LOC_ADV
en junto	LOC_ADV
en la línea de	LOC_PREP
en la necesidad de	LOC_PREP
en las cercanías de	LOC_PREP
en las proximidades de	LOC_PREP
en la temporada de	LOC_PREP
en la zona de	LOC_PREP
en limpio	LOC_ADV
en línea	LOC_ADV
en líneas generales	LOC_ADV
en lo concerniente a	LOC_PREP
en lontananza	LOC_ADV
en los buenos tiempos	LOC_ADV
en lo sucesivo	LOC_ADV
en lugar de	LOC_PREP
en lugar de que	LOC_CS
en mala hora	LOC_ADV
en mangas de camisa	LOC_ADV
en manos de	LOC_PREP
en materia de	LOC_PREP
en medio de	LOC_PREP
en memoria de	LOC_PREP
en menos de	LOC_PREP
#en miniatura	LOC_ADV
en mitad de	LOC_PREP
en modo alguno	LOC_ADV
en obligación de	LOC_PREP
en obsequio a	LOC_PREP
en obsequio de	LOC_PREP
en oferta	LOC_ADV
en oposición a	LOC_PREP
en orden a	LOC_PREP
en paños menores	LOC_ADV
en paralelo	LOC_ADV
en parte por	LOC_PREP
en partes iguales	LOC_ADV
en pelota picada	LOC_ADV
en pie de guerra	LOC_ADV
en plan de	LOC_PREP
en plantilla	LOC_ADV
en pocas palabras	LOC_ADV
en porretas	LOC_ADV
en pos de	LOC_PREP
en prenda	LOC_ADV
en primicia	LOC_ADV
en procura	LOC_ADV
en pro de	LOC_PREP
en prueba de	LOC_PREP
en punto de caramelo	LOC_ADV
en puridad	LOC_ADV
en rama	LOC_ADV
en razón de	LOC_PREP
en recuerdo de	LOC_PREP
en rededor	LOC_ADV
en remojo	LOC_ADV
en representación de	LOC_PREP
en resumidas cuentas	LOC_ADV
en ristre	LOC_ADV
en salvo	LOC_ADV
ensayo clínico	NCMS000
en seguida	LOC_ADV
en señal de	LOC_PREP
enseñanza básica	NCFS000
enseñanza de idiomas	NCFS000
enseñanza media	NCFS000
en sordina	LOC_ADV
en su defecto	LOC_ADV
en tándem	LOC_ADV
en tanto que	LOC_CS
ente público	NCFS000
entidad gestora	NCFS000
entidad pública	NCFS000
en tiempo de	LOC_PREP
en tiempo diferido	LOC_ADV
en tiempo real	LOC_ADV
en tiempo récord	LOC_ADV
en tiempo y forma	LOC_ADV
entlo.	Y
en toda la extensión de la palabra	LOC_ADV
en toda regla	LOC_ADV
en toda tierra de garbanzos	LOC_ADV
en todo caso	LOC_ADV
en todo lo descubierto	LOC_ADV
en torno a	LOC_PREP
en torno de	LOC_PREP
entorno de red	NCMS000
entorno social	NCMS000
en touche	LOC_ADV
entrada gratuita	NCFS000
entrega de premios	NCFS000
entre la espada y la pared	LOC_ADV
entre la vida y la muerte	LOC_ADV
entrenamiento físico	NCMS000
entre pecho y espalda	LOC_ADV
entre que	LOC_CS
entre tanto que	LOC_CS
en tromba	LOC_ADV
en un abrir y cerrar de ojos	LOC_ADV
en un decir amén	LOC_ADV
en un pis-pas	LOC_ADV
en un pispás	LOC_ADV
en un santiamén	LOC_ADV
en un tris	LOC_ADV
en vez de	LOC_PREP
en vez de que	LOC_CS
en vías de	LOC_PREP
en vilo	LOC_ADV
en virtud de	LOC_PREP
en vista de	LOC_PREP
en vista de que	LOC_CS
en volandas	LOC_ADV
en zigzag	LOC_ADV
e. p. d.	Y
e. p. m.	Y
equilibrio ecológico	NCMS000
equipo de fútbol	NCMS000
equipo de protección	NCMS000
equipo de sonido	NCMS000
equipo directivo	NCMS000
equipo docente	NCMS000
equipo informático	NCMS000
equipo nacional	NCMS000
erario público	NCMS000
escala de valores	NCFS000
esclerosis múltiple	NCMS000
escuela de arte	NCFS000
escuela de bellas artes	NCFS000
escuela de música	NCFS000
escuela oficial de idiomas	NCFS000
escuela rural	NCFS000
escuela taller	NCFS000
es hablar por demás	LOC_ADV
e. s. m.	Y
espacio económico europeo	NCMS000
espacio en blanco	NCMS000
especie humana	NCFS000
esperando a	LOC_PREP
estabilidad económica	NCFS000
estabilidad política	NCFS000
estación de autobús	NCFS000
estación de ferrocarril	NCFS000
estación de tren	NCFS000
estación meteorológica	NCFS000
estadio olímpico	NCMS000
estadística descriptiva	NCFS000
estado anímico	NCMS000
estado del bienestar	NCMS000
estado democrático	NCMS000
estado de salud	NCMS000
estado emocional	NCMS000
estado federal	NCMS000
estado independiente	NCMS000
estado miembro de la unión europea	NCMS000
estado nacional	NCMS000
estado sólido	NCMS000
estatutos sociales	NCMP000
estructura de datos	NCFS000
estructura económica	NCFS000
estructura familiar	NCFS000
estructura jerárquica	NCFS000
estructura social	NCFS000
estudio de grabación	NCMS000
estudio de impacto	NCMS000
estudio económico	NCMS000
estudios empresariales	NCMP000
et al.	Y
et alii	Y
AA. VV.	Y
etc.	Y
evaluación continua	NCFS000
evaluación del impacto ambiental	NCFS000
evaluación del riesgo	NCFS000
evaluación externa	NCFS000
evidencia científica	NCFS000
ex abrupto	LOC_ADV
ex aequo	LOC_ADV
ex ante	LOC_ADV
ex ante	LOC_AQ0CN0
ex cátedra	LOC_ADV
ex cathedra	LOC_ADV
ex cáthedra	LOC_ADV
Exc.ª	Y
exceptio veritatis	LOC_ADV
excepto que	LOC_CS
exceso de velocidad	NCMS000
excl.	Y
Excma.	Y
Excmo.	Y
expansión económica	NCFS000
# expediente disciplinario	LOC_NC
explotación agrícola	NCFS000
exposición itinerante	NCFS000
exposición permanente	NCFS000
ex post	LOC_ADV
ex post	LOC_AQ0CN0
expresión artística	NCFS000
expresión escrita	NCFS000
expresión oral	NCFS000
expresión plástica	NCFS000
ex profeso	LOC_ADV
ex testamento	LOC_ADV
extrema derecha	NCFS000
e/	Y
# factor ambiental	LOC_NC
# factor de riesgo	LOC_NC
facultad de bellas artes	NCFS000
facultad de derecho	NCFS000
facultad de psicología	NCFS000
fal Fh s	NCFS000
falso testimonio	NCMS000
farmacología clínica	NCFS000
fasc.	Y
fata morgana	NCFS000
fauna marina	NCFS000
f.ª	Y
fca.	Y
F. C.	Y
Fdo.	Y
fecha de cierre	NCFS000
fecha de emisión	NCFS000
fecha de solicitud	NCFS000
fecha límite	NCFS000
fecha tope	NCFS000
fe cristiana	NCFS000
féc.	Y
federación nacional	NCFS000
FF. AA.	Y
ficha técnica	NCFS000
fichero de datos	NCMS000
figura jurídica	NCFS000
fig.	Y
filología clásica	NCFS000
filosofía de la ciencia	NCFS000
filosofía del derecho	NCFS000
filosofía política	NCFS000
# final feliz	LOC_NC
# fiscal jefe	LOC_NC
física aplicada	NCFS000
física nuclear	NCFS000
física teórica	NCFS000
flujo de aire	NCFS000
flujo de caja	NCFS000
flujo de datos	NCFS000
flujo de fondos	NCFS000
flujo de información	NCFS000
foie gras	NCMS000
fol.	Y
fondo de garantía	NCMS000
fondo de pensiones	NCMS000
fondo documental	NCMS000
fondo europeo de desarrollo	NCMS000
fondo monetario internacional	NCMS000
fondo social europeo	NCMS000
formación humana	NCFS000
formación ocupacional	NCFS000
formación profesional específica	NCFS000
formación profesional ocupacional	NCFS000
forma gráfica	NCFS000
formato html	NCFS000
fosa nasal	NCFS000
fotografía aérea	NCFS000
fox terrier	NCMN000
f.º	Y
frame relay	NCFS000
fra.	Y
frecuencia cardiaca	NCFS000
free lance	NCMN000
frente nacional	NCFS000
frente popular	NCFS000
fruta fresca	NCFS000
fruto seco	NCMS000
Fr.	Y
ft3 Fh min	NCFS000
ft3 Fh s	NCFS000
ft Fh h	NCFS000
ft Fh min	NCFS000
ft Fh s2	NCFS000
ft Fh s	NCFS000
fuente de alimentación	NCFS000
fuente de datos	NCFS000
fuente de energía	NCFS000
fuente de financiación	NCFS000
fuente de luz	NCFS000
fuera de que	LOC_CS
fuerza física	NCFS000
fuerza militar	NCFS000
fuerzas de ocupación	NCFP000
fuerzas de seguridad	NCFP000
fuerzas y cuerpos de seguridad	NCFP000
fuga de capitales	NCFS000
full time	LOC_ADV
full time	LOC_AQ0CN0
función administrativa	NCFS000
fundamento jurídico	NCMS000
fundamentos de derecho	NCMP000
fútbol base	NCMS000
f.	Y
# gabinete técnico	LOC_NC
galería comercial	NCFS000
gal Fh ac Fh d	NCFS000
gal Fh cap Fh d	NCFS000
gal Fh d	NCFS000
gal Fh ft2 d	NCFS000
gal Fh ft2 Fh min	NCFS000
gal Fh ft2	NCFS000
gal Fh h	NCFS000
gal Fh min	NCFS000
galón acre Fh día	NCMS000
galón acre por día	NCMS000
galón cápita Fh día	NCMS000
galón cápita por día	NCMS000
galón día	NCMS000
galón Fh acre día	NCMS000
galón Fh acre Fh día	NCMS000
galón Fh acre por día	NCMS000
galón Fh cápita día	NCMS000
galón Fh cápita Fh día	NCMS000
galón Fh cápita por día	NCMS000
galón Fh día	NCMS000
galón Fh hora	NCMS000
galón Fh minuto	NCMS000
galón Fh pie cuadrado día	NCMS000
galón Fh pie cuadrado Fh día	NCMS000
galón Fh pie cuadrado Fh minuto	NCMS000
galón Fh pie cuadrado	NCMS000
galón Fh pie cuadrado minuto	NCMS000
galón Fh pie cuadrado por día	NCMS000
galón Fh pie cuadrado por minuto	NCMS000
galón Fh segundo	NCMS000
galón hora	NCMS000
galón minuto	NCMS000
galón per cápita día	NCMS000
galón per cápita Fh día	NCMS000
galón per cápita por día	NCMS000
galón pie cuadrado Fh día	NCMS000
galón pie cuadrado Fh minuto	NCMS000
galón pie cuadrado por día	NCMS000
galón pie cuadrado por minuto	NCMS000
galón por acre día	NCMS000
galón por acre Fh día	NCMS000
galón por acre por día	NCMS000
galón por acre y día	NCMS000
galón por cápita día	NCMS000
galón por cápita Fh día	NCMS000
galón por cápita por día	NCMS000
galón por día	NCMS000
galón por hora	NCMS000
galón por minuto	NCMS000
galón por pie cuadrado día	NCMS000
galón por pie cuadrado Fh día	NCMS000
galón por pie cuadrado Fh minuto	NCMS000
galón por pie cuadrado	NCMS000
galón por pie cuadrado minuto	NCMS000
galón por pie cuadrado por día	NCMS000
galón por pie cuadrado por minuto	NCMS000
galón por pie cuadrado y día	NCMS000
galón por pie cuadrado y minuto	NCMS000
galón por segundo	NCMS000
galón segundo	NCMS000
gama de productos	NCFS000
ganancia neta	NCFS000
garantía constitucional	NCFS000
garantía hipotecaria	NCFS000
gastos corrientes	NCMP000
gastos de administración	NCMP000
gastos de capital	NCMP000
gastos de funcionamiento	NCMP000
gastos de gestión	NCMP000
gastos de mantenimiento	NCMP000
gastos de personal	NCMP000
gastos de transporte	NCMP000
gastos de viaje	NCMP000
gastos fijos	NCMP000
gastos financieros	NCMP000
gastos públicos	NCMP000
gastos sociales	NCMP000
Gdor.ª	Y
Gdora.	Y
Gdor.	Y
género literario	NCMS000
Gengis Kan	NPMNSP0
geografía física	NCFS000
geografía humana	NCFS000
geometría analítica	NCFS000
gestión administrativa	NCFS000
gestión clínica	NCFS000
gestión de datos	NCFS000
gestión de la empresa	NCFS000
gestión de personal	NCFS000
gestión económica	NCFS000
gestión educativa	NCFS000
gestión empresarial	NCFS000
gestión interna	NCFS000
gestión medioambiental	NCFS000
gestión sanitaria	NCFS000
gestión urbanística	NCFS000
g Fh l	NCMP000
g Fh m3	NCMP000
gimnasia artística	NCFS000
giro postal	NCMS000
globalización de la economía	NCFS000
Gloria Patri	NCMN000
gobierno central	NCMS000
gobierno civil	NCMS000
gobierno constitucional	NCMS000
gobierno federal	NCMS000
gobierno local	NCMS000
gobierno militar	NCMS000
gobierno provisional	NCMS000
gobierno revolucionario	NCMS000
Gob.	Y
# golpe militar	LOC_NC
g/p	Y
g. p.	Y
gracia de dios	NCFS000
gracias a	LOC_PREP
gracias al que	LOC_CS
gracias a que	LOC_CS
grado celsius	NCMS000
grado centígrado	NCMS000
grado de madurez	NCMS000
grado farenheit	NCMS000
grado kelvin	NCMS000
Gral.	Y
gramo Fh litro	NCMS000
gramo Fh metro cúbico	NCMS000
gramo por litro	NCMS000
gramo por metro cúbico	NCMS000
gratis et amore	LOC_ADV
gripe aviar	NCFS000
grosso modo	LOC_ADV
grupo de edad	NCMS000
grupo de empresas	NCMS000
grupo de noticias	NCMS000
grupo de trabajo	NCMS000
grupo social	NCMS000
guardería infantil	NCFS000
guardia civil	NCFS000
guardia nacional	NCFS000
guerra civil española	NCFS000
guerra fría	NCFS000
guerra mundial	NCFS000
guía de turismo	NCFS000
guía didáctica	NCFS000
g. v.	Y
habeas corpus	NCMN000
hab Fh km	NCFS000
habitación doble	NCFS000
habitación individual	NCFS000
habitante Fh km2	NCMS000
habitante Fh kms2	NCMS000
habitante por kilómetro cuadrado	NCMS000
habitante por km2	NCMS000
hábito alimentario	NCMS000
hacia mediados de	LOC_PREP
hacienda pública	NCFS000
hasta cierto punto	LOC_ADV
hasta cuando	LOC_CS
hasta más ver	LOC_ADV
hasta tanto que	LOC_CS
heavy metal	AQ0CN0
hecho imponible	NCMS000
hechos de los apóstoles	NCMP000
herramientas de gestión	NCFP000
hic et nunc	LOC_ADV
high tech	LOC_ADJ
high tech	LOC_AQ0CN0
higiene bucal	NCFP000
hijo pródigo	NCMS000
hipótesis de trabajo	NCFN000
historia clínica	NCFS000
historia de la educación	NCFS000
historia de la filosofía	NCFS000
historia del arte	NCFS000
historia económica	NCFS000
Hna.	Y
Hno.	Y
hoja de papel	NCFS000
hoja informativa	NCFS000
Hong Kong	NPCSG00
honoris causa	LOC_ADJ
honoris causa	LOC_AQ0CN0
horario de atención al público	NCMS000
horario de clases	NCMS000
horario de mañana	NCMS000
horario de verano	NCMS000
horario laboral	NCMS000
horas de oficina	NCFP000
horas de sol	NCFP000
horas hábiles	NCFP000
horno microondas	NCMS000
horror vacui	NCMS000
hospital general	NCMS000
# hospital infantil	LOC_NC
huella digital	NCFS000
humanidades y ciencias sociales	NCFP000
humedad relativa	NCFS000
H.	Y
ibíd.	Y
ib.	Y
id. de usuario	NCMS000
ídem de ídem	LOC_ADV
# identidad nacional	LOC_NC
identidad sexual	NCFS000
íd.	Y
i. e.	Y
igl.ª	Y
iglesia anglicana	NCFS000
iglesia católica	NCFS000
iglesia evangélica	NCFS000
iglesia ortodoxa	NCFS000
iglesia universal	NCFS000
igualdad de derechos	NCFS000
igualdad de oportunidades	NCFS000
igualdad entre hombres y mujeres	NCFS000
igualdad social	NCFS000
Ilma.	Y
Ilmo.	Y
Iltre.	Y
Il.	Y
imagen de marca	NCFS000
imagen personal	NCFS000
impacto ambiental	NCMS000
impacto medioambiental	NCMS000
impacto visual	NCMS000
imperio de la ley	NCMS000
impreso de solicitud	NCMS000
impr.	Y
impto.	Y
impuesto de sociedades	NCMS000
impuesto sobre actividades económicas	NCMS000
impuesto sobre bienes inmuebles	NCMS000
impuesto sobre el valor añadido	NCMS000
impuesto sobre la renta de las personas físicas	NCMS000
impuesto sobre la renta	NCMS000
impuesto sobre sociedades	NCMS000
impuesto sobre transmisiones patrimoniales	NCMS000
imp.	Y
in absentia	LOC_ADV
in aeternum	LOC_ADV
in albis	LOC_ADV
in anima vili	LOC_ADV
in ánima vili	LOC_ADV
in articulo mortis	LOC_ADV
in artículo mortis	LOC_ADV
incapacidad laboral	NCFS000
incapacidad permanente	NCFS000
incapacidad temporal	NCFS000
incl.	Y
incontinencia urinaria	NCFS000
incremento salarial	NCMS000
in crescendo	LOC_ADV
índice de desarrollo humano	NCMS000
índice de precios al consumo	NCMS000
industria nacional	NCFS000
industria química	NCFS000
in extenso	LOC_ADV
in extremis	LOC_ADV
in Fh s2	NCFS000
in fieri	LOC_ADV
influencia política	NCFS000
información adicional	NCFS000
información general	NCFS000
información genética	NCFS000
información tecnológica	NCFS000
información turística	NCFS000
informática de gestión	NCFS000
informe de auditoría	NCMS000
informe de evaluación	NCMS000
informe de gestión	NCMS000
in fraganti	LOC_ADV
ingeniería química	NCMS000
ingeniero agrónomo	NCMS000
ingeniero químico	NCMS000
ingeniero técnico agrícola	NCMS000
Ing.	Y
iniciativa legislativa	NCFS000
in illo tempore	LOC_ADV
in illo témpore	LOC_ADV
inmediatamente después de	LOC_PREP
in memóriam	LOC_ADV
in pártibus infidélium	LOC_ADV
in partibus	LOC_ADV
in partibus	LOC_AQ0CN0
in pectore	LOC_ADV
in péctore	LOC_ADV
in perpétuum	LOC_ADV
in promptu	LOC_ADV
in púribus	LOC_ADV
in situ	LOC_ADV
in sólidum	LOC_ADV
# inspector general	LOC_NC
instituto nacional de empleo	NCMS000
instituto nacional de la salud	NCMS000
instituto nacional de la seguridad social	NCMS000
instituto nacional de meteorología	NCMS000
instrucciones de uso	NCFP000
instrumento musical	NCMS000
Inst.	Y
integración económica	NCFS000
integración social	NCFS000
inteligencia humana	NCFS000
interacción social	NCFS000
intercambio de datos	NCMS000
interés social	NCMS000
# interfaz de usuario	LOC_NC
inter nos	LOC_ADV
interposita persona	LOC_ADV
intervalo de tiempo	NCMS000
intervención quirúrgica	NCFS000
inter vivos	LOC_ADV
investigación clínica	NCFS000
invita Minerva	LOC_ADV
in vitro	LOC_ADV
in vitro	LOC_AQ0CN0
in vivo	LOC_ADV
in vivo	LOC_AQ0CN0
ipso facto	LOC_ADV
ipso iure	LOC_ADV
ipso jure	LOC_ADV
Islas Solomon	NPFPG00
Italo Calvino	NPMSSP0
iuris et de iure	LOC_ADV
I.	Y
izda.	Y
izdo.	Y
izqda.	Y
izqdo.	Y
izq.	Y
jamás de los jamases	LOC_ADV
jamás por jamás	LOC_ADV
J. C.	Y
jefe de gabinete	NCCS000
jefe de proyecto	NCCS000
jefe de seguridad	NCCS000
jefe de unidad	NCCS000
jefe militar	NCCS000
jet lag	NCMS000
jet set	NCFS000
J Fh K	NCFS000
Jhs.	Y
JJ. OO.	Y
joule Fh grado kelvin	NCMS000
joule Fh kelvin	NCMS000
joule Fh K	NCMS000
joule por grado kelvin	NCMS000
joule por kelvin	NCMS000
jubilación anticipada	NCFS000
juego de mesa	NCMS000
juegos olímpicos	NCMP000
juicio oral	NCMS000
junta general de accionistas	NCFS000
junta militar	NCFS000
junto a	LOC_PREP
junto con	LOC_PREP
jurisdicción contencioso-administrativa	NCFS000
jurisdicción ordinaria	NCFS000
jurisdicción penal	NCFS000
juro a bríos	LOC_ADV
justicia ordinaria	NCFS000
justicia social	NCFS000
kg Fh cm2	NCMP000
kg Fh m2	NCMP000
kg Fh m3	NCMP000
kg Fh s	NCFS000
kilogramo Fh centímetro cuadrado	NCMS000
kilogramo Fh metro cuadrado	NCMS000
kilogramo Fh metro cúbico	NCMS000
kilogramo Fh segundo	NCMS000
kilogramo por centímetro cuadrado	NCMS000
kilogramo por metro cuadrado	NCMS000
kilogramo por metro cúbico	NCMS000
kilogramo por segundo	NCMS000
kilómetro cuadrado	NCMS000
kilómetro Fh h Fh s	NCMS000
kilómetro Fh h	NCMS000
kilómetro Fh hora Fh segundo	NCMS000
kilómetro Fh hora	NCMS000
kilómetro Fh hora por segundo	NCMS000
kilómetro Fh hora segundo	NCMS000
kilómetro Fh segundo	NCMS000
kilómetro Fh s	NCMS000
kilómetro hora Fh segundo	NCMS000
kilómetro hora por segundo	NCMS000
kilómetro hora segundo	NCMS000
kilómetro por hora Fh segundo	NCMS000
kilómetro por hora	NCMS000
kilómetro por hora por segundo	NCMS000
kilómetro por segundo	NCMS000
kilómetro segundo	NCMS000
km Fh h Fh s	NCFS000
km Fh h	NCFS000
kn Fh s	NCFS000
k. o.	Y
Kublai Kan	NPMNSP0
laboratorio clínico	NCMS000
labor docente	NCFS000
lactancia materna	NCFS000
laissez faire	NCMS000
la madre tierra	NCMS000
lapsus calami	NCMN000
lapsus linguae	NCMN000
lato sensu	LOC_ADV
laudo arbitral	NCFS000
laus Deo	LOC_ADV
lb Fh ft2	NCFP000
lb Fh ft3	NCFP000
lb Fh in2	NCFP000
lb Fh milgal	NCFP000
Lcda.	Y
Lcdo.	Y
l. c.	Y
Lda.	Y
Ldo.	Y
leche de vaca	NCFS000
# lector de cd	LOC_NC
legislación autonómica	NCFS000
legislación nacional	NCFS000
legislación vigente	NCFS000
legítima defensa	NCFS000
lejos de	LOC_PREP
lengua de oc	NCFS000
lengua de oíl	NCFS000
lengua extranjera	NCFS000
lengua internacional	NCFS000
lenguaje corporal	NCMS000
# lenguaje de programación	LOC_NC
lenguaje escrito	NCMS000
lenguaje oral	NCMS000
lengua oficial	NCFS000
lenguas de oc	NCFP000
lenguas de oíl	NCFP000
ley del suelo	NCFS000
ley de procedimiento administrativo	NCFS000
ley fundamental	NCFS000
ley general de educación	NCFS000
ley general	NCFS000
ley general presupuestaria	NCFS000
ley general tributaria	NCFS000
ley marco	NCFS000
ley orgánica del poder judicial	NCFS000
# ley vigente	LOC_NC
l Fh día	NCFS000
l Fh d	NCFS000
l Fh m2 Fh d	NCFS000
l Fh m2 Fh min	NCFS000
l Fh m2 Fh s	NCFS000
l Fh m2	NCFS000
l Fh min	NCFS000
l Fh s	NCFS000
libertad de asociación	NCFS000
libertad de expresión	NCFS000
libertad de opinión	NCFS000
libertad de pensamiento	NCFS000
libertad de prensa	NCFS000
libertades fundamentales	NCFP000
libertad religiosa	NCFS000
libra Fh milgalón	NCFS000
libra Fh pie cuadrado	NCFS000
libra Fh pie cúbico	NCFS000
libra Fh pulgada cuadrada	NCFS000
libra fuerza	NCFS000
libra milgalón	NCFS000
libra por milgalón	NCFS000
libra por pie cuadrado	NCFS000
libra por pie cúbico	NCFS000
libra por pulgada cuadrada	NCFS000
licencia de obras	NCFS000
Lic.	Y
liga árabe	NCFS000
lignum crucis	LOC_ADV
Lincoln Lincoln	NPCNSP0
línea de acción	NCFS000
línea eléctrica	NCFS000
línea fija	NCFS000
literatura juvenil	NCFS000
litro día cápita	NCMS000
litro día per cápita	NCMS000
litro día por cápita	NCMS000
litro Fh día Fh cápita	NCMS000
litro Fh día por cápita	NCMS000
litro Fh metro cuadrado Fh dia	NCMS000
litro Fh metro cuadrado Fh minuto	NCMS000
litro Fh metro cuadrado Fh segundo	NCMS000
litro Fh metro cuadrado	NCMS000
litro Fh metro cuadrado por dia	NCMS000
litro Fh metro cuadrado por minuto	NCMS000
litro Fh metro cuadrado por segundo	NCMS000
litro Fh minuto	NCMS000
litro Fh segundo	NCMS000
litro metro cuadrado por día	NCMS000
litro metro cuadrado por minuto	NCMS000
litro metro cuadrado por segundo	NCMS000
litro por día cápita	NCMS000
litro por día Fh cápita	NCMS000
litro por día	NCMS000
litro por día per cápita	NCMS000
litro por día por cápita	NCMS000
litro por metro cuadrado día	NCMS000
litro por metro cuadrado Fh dia	NCMS000
litro por metro cuadrado Fh minuto	NCMS000
litro por metro cuadrado Fh segundo	NCMS000
litro por metro cuadrado	NCMS000
litro por metro cuadrado minuto	NCMS000
litro por metro cuadrado por dia	NCMS000
litro por metro cuadrado por minuto	NCMS000
litro por metro cuadrado por segundo	NCMS000
litro por metro cuadrado segundo	NCMS000
litro por metro cuadrado y día	NCMS000
litro por metro cuadrado y minuto	NCMS000
litro por metro cuadrado y segundo	NCMS000
litro por minuto	NCMS000
litro por segundo	NCMS000
lluvia torrencial	NCFS000
# local comercial	LOC_NC
loc. cit.	Y
loco citato	LOC_ADV
lo de menos	LOC_ADV
lo malo es que	LOC_CS
lo uno por lo otro	LOC_ADV
Ltda.	Y
Ltdo.	Y
Ltd.	Y
lt Fh d per càpita	NCFS000
lt Fh d por càpita	NCFS000
lt Fh m2 Fh d	NCFS000
lt Fh m2 Fh min	NCFS000
lt Fh m2 Fh s	NCFS000
lt Fh m2	NCFS000
lucha armada	NCFS000
lucha por el poder	NCFS000
lucro cesante	NCMS000
luego que	LOC_CS
# lugar de nacimiento	LOC_NC
# luz blanca	LOC_NC
L/	Y
m3 Fh ha Fh d	NCFS000
m3 Fh h	NCFS000
m3 Fh hora	NCFS000
m3 Fh m2 Fh d	NCFS000
m3 Fh m2 Fh h	NCFS000
m3 Fh seg	NCFS000
m3 Fh s	NCFS000
madre naturaleza	NCFS000
# madre soltera	LOC_NC
Magallanes Magallanes	NPCNSP0
Magfca.	Y
Magfco.	Y
magister dixit	LOC_ADV
maguer que	LOC_CS
mal a mal	LOC_ADV
manu militari	LOC_ADV
mapa topográfico	NCFS000
máquina virtual	NCFS000
marco de referencia	NCMS000
marco general	NCMS000
Mare Nostrum	NPMSG00
margen bruto	NCCS000
más allá de	LOC_PREP
más de la cuenta	LOC_ADV
mass media	NCMN000
mass media	NCMP000
más valiera	LOC_ADV
matemática aplicada	NCFS000
# material complementario	LOC_NC
material de oficina	NCMS000
material eléctrico	NCMS000
material escrito	NCMS000
material plástico	NCMS000
matrimonio civil	NCMS000
máx.	Y
mea culpa	NCMN000
mecánica cuántica	NCFS000
mecánica de fluidos	NCFS000
medalla de bronce	NCFS000
medalla de oro	NCFS000
medalla de plata	NCFS000
media jornada	NCFS000
mediana empresa	NCFS000
medicina de urgencias	NCFS000
medicina general	NCFS000
medicina interna	NCFS000
medicina natural	NCFS000
medicina nuclear	NCFS000
médico general	NCMS000
médicos sin fronteras	NCMP000
medida de seguridad	NCFS000
medio ambiente	NCMS000
medio ambiente	NCMS000
medio de transporte	NCMS000
medio natural	NCMS000
medio rural	NCMS000
medios de comunicación de masas	NCMP000
medios de comunicación	NCMP000
medios económicos	NCMP000
medio urbano	NCMS000
memoria anual	NCFS000
memoria ram	NCFS000
memoria virtual	NCFS000
mensaje de correo electrónico	NCMS000
mensaje de error	NCMS000
mensaje electrónico	NCMS000
mercado abierto	NCMS000
mercado bursátil	NCMS000
mercado secundario	NCMS000
merced a que	LOC_CS
mesa de negociación	NCFS000
método científico	NCMS000
metro cuadrado	NCMS000
metro cúbico Fh hora	NCMS000
metro cúbico Fh segundo	NCMS000
metro cúbico por hora	NCMS000
metro cúbico por segundo	NCMS000
metro Fh segundo	NCMS000
metro Fh s	NCMS000
metro por segundo	NCMS000
metro segundo	NCMS000
m Fh s	NCFS000
miembro del consejo	NCMS000
miembro del partido	NCMS000
miembro titular	NCMS000
mientras que	LOC_CS
mi Fh h	NCFS000
milímetro cuadrado	NCMS000
milímetro cúbico	NCMS000
milímetro de hg	NCMS000
milímetro de mercurio	NCMS000
milla cuadrado	NCFS000
milla Fh hora	NCFS000
milla por hora	NCFS000
ministerio de asuntos exteriores	NCMS000
ministerio de educación y ciencia	NCMS000
ministerio de hacienda	NCMS000
ministerio de justicia	NCMS000
ministro de asuntos exteriores	NCMS000
ministro de hacienda	NCMS000
ministro de obras públicas	NCMS000
mín.	Y
mirando a	LOC_PREP
mirando hacia	LOC_PREP
misión comercial	NCFS000
mixti fori	LOC_ADV
ml Fh d	NCFS000
mlt Fh d	NCFS000
m. n.	Y
mobiliario urbano	NCFS000
modelo conceptual	NCMS000
modelo de gestión	NCMS000
modelo económico	NCMS000
modelo matemático	NCMS000
modelo oficial	NCMS000
modelo teórico	NCMS000
modificación de datos	NCFS000
modus operandi	NCMN000
modus vivendi	NCMN000
moliente y corriente	AQ0CS0
moneda nacional	NCFS000
moneda única	NCFS000
monóxido de carbono	NCFS000
Mons.	Y
mortalidad infantil	NCFS000
mortis causa	LOC_ADV
motor de búsqueda	NCMS000
motor eléctrico	NCMS000
motu proprio	LOC_ADV
motu proprio	LOC_AQ0CN0
movilidad geográfica	NCFS000
movimiento de resistencia	NCMS000
movimiento internacional	NCMS000
movimiento nacional	NCMS000
movimiento obrero	NCMS000
movimiento revolucionario	NCMS000
mr.	Y
ms.	Y
# muerte violenta	LOC_NC
muestra representativa	NCFS000
mundo material	NCMS000
música de cámara	NCFS000
música electrónica	NCFS000
música moderna	NCFS000
música popular	NCFS000
música religiosa	NCFS000
mutatis mutandis	LOC_ADV
muy de mañana	LOC_ADV
muy muy	LOC_ADV
M.	Y
m.	Y
naciones unidas	NCFP000
nada más y nada menos	LOC_ADV
N.ª S.ª	Y
naturaleza humana	NCFS000
naturaleza jurídica	NCFS000
navegación aérea	NCFS000
navegación marítima	NCFS000
N. B.	Y
N. del T.	Y
Nebrija Nebrija	NPCNSP0
# necesidad básica	LOC_NC
necesidades educativas especiales	NCFP000
negociación colectiva	NCFS000
nemine discrepante	LOC_ADV
new look	LOC_AQ0CN0
new look	NCMS000
# newton Fh metro cuadrado	LOC_NC
# newton por metro cuadrado	LOC_NC
N Fh m2	NCMP000
ni a la de tres	LOC_ADV
ni a tiros	LOC_ADV
ni aún	LOC_ADV
ni corto ni perezoso	LOC_ADV
ni fu ni fa	LOC_ADV
ni hablar del peluquín	LOC_ADV
nihil obstat	NCMN000
ni más ni menos	LOC_ADV
ni mucho menos	LOC_ADV
ni que decir tiene	LOC_ADV
ni que	LOC_CS
ni remotamente	LOC_ADV
ni rey ni roque	LOC_ADV
ni suena ni truena	LOC_ADV
ni tan sólo	LOC_ADV
ni tanto así	LOC_ADV
ni tanto ni tan calvo	LOC_ADV
ni tanto ni tan poco	LOC_ADV
# nivel de calidad	LOC_NC
# nivel de confianza	LOC_NC
nivel de empleo	NCMS000
nivel de estudios	NCMS000
nivel de exigencia	NCMS000
nivel de precios	NCMS000
# nivel de seguridad	LOC_NC
nivel de vida	NCMS000
nivel educativo	NCMS000
nivel técnico	NCMS000
no ha lugar	LOC_ADV
noli me tangere	LOC_ADV
nombre comercial	NCMS000
nombre del archivo	NCMS000
nombre de usuario	NCMS000
non bis in idem	NCMS000
non plus ultra	LOC_ADV
no obstante	LOC_ADV
no obstante	LOC_CC
nora en tal	LOC_ADV
nora tal	LOC_ADV
norma básica	NCFS000
norma jurídica	NCFS000
normalización lingüística	NCFS000
normas de aplicación	NCFP000
normas de seguridad	NCFP000
normas sociales	NCFP000
normativa vigente	NCFS000
no sea que	LOC_CS
nota bene	NCMN000
nota media	NCFS000
nota simple	NCFS000
n.º	Y
nro.	Y
N. S. J. C.	Y
N. S.	Y
Ntr.ª Sr.ª	Y
Ntra. Sra.	Y
núcleo familiar	NCMS000
nueces moscadas	NCFP000
nueva economía	NCFS000
Nueva Zelanda	NPFSG00
nuez moscada	NCFS000
número de alumnos	NCMS000
número de cuenta	NCMS000
número de identificación fiscal	NCMS000
número de identificación	NCMS000
número de profesores	NCMS000
números rojos	NCMP000
numerus clausus	NCMN000
núm.	Y
n.	Y
ob. cit.	Y
obispo auxiliar	NCMS000
obiter dictum	LOC_ADV
obra de teatro	NCFS000
obra nueva	NCFS000
obras de infraestructura	NCFP000
obra social	NCFS000
observatorio astronómico	NCMS000
Ob.	Y
ocupación militar	NCFS000
oferta educativa	NCFS000
off line	LOC_ADV
oficina central	NCFS000
oficina de empleo	NCFS000
oficina de información	NCFS000
oficina principal	NCFS000
oficina técnica	NCFS000
O. F. M.	Y
ola de calor	NCFS000
ola de frío	NCFS000
óleo sobre lienzo	NCMS000
O. M.	Y
oncología médica	NCFS000
on line	LOC_ADV
onza fluido	NCFS000
opción de compra	NCFS000
óp. cit.	Y
operación comercial	NCFS000
operación militar	NCFS000
operador o	NCFS000
operador y	NCFS000
ópera prima	NCFS000
O. P.	Y
ordenación general del sistema educativo	NCFS000
ordenación urbana	NCFS000
ordenamiento jurídico	NCMS000
ordenanza fiscal	NCFS000
ordenanza municipal	NCFS000
orden constitucional	NCFS000
orden de prioridad	NCFS000
orden establecido	NCFS000
orden jurídico	NCFS000
orden jurisdiccional	NCFS000
orden ministerial	NCFS000
organismo oficial	NCMS000
organización de empresas	NCFS000
organización de las naciones unidas	NCFS000
organización de las naciones unidas para la agricultura y la alimentación	NCFS000
organización de las naciones unidas para la educación, la ciencia y la cultura	NCFS000
organización de los estados americanos	NCFS000
organización sin fines de lucro	NCFS000
organización social	NCFS000
órgano consultivo	NCMS000
órgano de gobierno	NCMS000
orientación educativa	NCFS000
O. S. A.	Y
o sea	LOC_CC
oso hormiguero	NCMS000
óxido nítrico	NCFS000
pacto social	NCMS000
padrón municipal	NCMS000
página personal	NCFS000
página web	NCFS000
página web personal	NCFS000
pago anticipado	NCMS000
pago en efectivo	NCMS000
pág.	Y
paisaje natural	NCMS000
paisaje urbano	NCMS000
# país en desarrollo	LOC_NC
palacio de justicia	NCMS000
palacio de los deportes	NCMS000
pane lucrando	LOC_ADV
panem et circenses	LOC_ADV
Pange lingua	LOC_ADV
pantalla de cristal liquido	NCFS000
pantalla de cristal líquido	NCFS000
papel continuo	NCMS000
para colmo	LOC_ADV
para dar y tomar	LOC_ADV
# parálisis cerebral	LOC_NC
para más inri	LOC_ADV
# para que	LOC_CS # see QUE Pare que sirve?
para rato	LOC_ADV
para remate	LOC_ADV
para todo trote	LOC_ADV
parecido a	LOC_PREP
parlamento europeo	NCMS000
parlamento vasco	NCMS000
# parque de bomberos	LOC_NC
# parque eólico	LOC_NC
párr.	Y
# parte contratante	LOC_NC
partida de nacimiento	NCFS000
partido amistoso	NCMS000
partido comunista	NCMS000
partido conservador	NCMS000
partido de ida	NCMS000
partido de vuelta	NCMS000
partido liberal	NCMS000
partido oficial	NCMS000
partido político	NCMS000
partido socialista obrero español	NCMS000
pasado mañana	LOC_ADV
pasión de cristo	NCFS000
patata frita	NCFS000
patrimonio artístico	NCMS000
patrimonio cultural	NCMS000
patrimonio histórico-artístico	NCMS000
Pat.	Y
p. a.	Y
Pbro.	Y
pdo.	Y
Pdta.	Y
Pdte.	Y
P. D.	Y
p. d.	Y
peccata minuta	LOC_ADV
peccata minuta	LOC_AQ0CN0
peccata minuta	NCFS000
p. ej.	Y
pensamiento filosófico	NCMS000
pensión de jubilación	NCFS000
pequeña empresa	NCFS000
pequeñas y medianas empresas	NCFP000
per accidens	LOC_ADV
per cápita	AQ0CN0
Per cápita	LOC_AQ0CN0
período de vacaciones	NCMS000
período de validez	NCMS000
período de vigencia	NCMS000
permiso de conducir	NCMS000
permiso de residencia	NCMS000
per se	LOC_ADV
persona de edad avanzada	NCFS000
personal administrativo	NCMS000
personal docente	NCMS000
personalidad jurídica	NCFS000
personalidad jurídica propia	NCFS000
persona non grata	NCFS000
perspectiva histórica	NCFS000
perspectivas económicas	NCFP000
pescado fresco	NCMS000
#pese a	LOC_PREP
pese a que	LOC_CS
Petrus in cunctis	LOC_ADV
pg.	Y
pian pianito	LOC_ADV
pian pian	LOC_ADV
pian piano	LOC_ADV
pie cuadrado	NCMS000
pie cúbico Fh minuto	NCMS000
pie cúbico Fh segundo	NCMS000
pie cúbico	NCMS000
pie cúbico por minuto	NCMS000
pie cúbico por segundo	NCMS000
pie de agua	NCMS000
pie Fh hora	NCMS000
pie Fh minuto	NCMS000
pie Fh segundo Fh segundo	NCMS000
pie Fh segundo	NCMS000
pie Fh segundo por segundo	NCMS000
pie Fh segundo segundo	NCMS000
pie hora	NCMS000
pie minuto	NCMS000
pie por hora	NCMS000
pie por minuto	NCMS000
pie por segundo al cuadrado	NCMS000
pie por segundo cuadrado	NCMS000
pie por segundo Fh segundo	NCMS000
pie por segundo	NCMS000
pie por segundo por segundo	NCMS000
pie por segundo segundo	NCMS000
pie segundo Fh segundo	NCMS000
pie segundo	NCMS000
pie segundo por segundo	NCMS000
pie segundo segundo	NCMS000
piscina cubierta	NCFS000
p. k.	Y
plan de emergencia	NCMS000
plan de gestión	NCMS000
plan general de contabilidad	NCMS000
planificación económica	NCFS000
planificación familiar	NCFS000
plano de situación	NCMS000
play back	NCMN000
play boy	NCMS000
play boys	NCMP000
plazo de admisión	NCMS000
pleno del ayuntamiento	NCMS000
pleno empleo	NCMS000
pleno municipal	NCMS000
plis plas	NCMS000
pluralia tantum	LOC_ADV
plus minusve	LOC_ADV
plus ultra	LOC_ADV
pl.	Y
plza.	Y
P. M.	Y
p. m.	Y
Pnt.	Y
población objetivo	NCFS000
poco a poco	LOC_ADV
policía judicial	NCCS000
polígono industrial	NCMS000
política ambiental	NCFS000
política de defensa	NCFS000
política de empleo	NCFS000
política económica	NCFS000
pop art	AQ0CN0
por adarmes	LOC_ADV
por al lado de	LOC_PREP
por amor de Dios	LOC_ADV
por anticipado	LOC_ADV
por aquel entonces	LOC_ADV
por arte de birlibirloque	LOC_ADV
por arte de magia	LOC_ADV
por barba	LOC_ADV
por carambola	LOC_ADV
por causa de	LOC_PREP
por ce o por be	LOC_ADV
por ceremonia	LOC_ADV
por concuerda	LOC_ADV
por consecuencia	LOC_ADV
por consiguiente	LOC_ADV
por contera	LOC_ADV
por cuatro reales	LOC_ADV
por cuenta de	LOC_PREP
por cuenta y riesgo	LOC_ADV
por debajo de cuerda	LOC_ADV
por debajo de	LOC_PREP
por decirlo así	LOC_ADV
por de contado	LOC_ADV
por delante de	LOC_PREP
por dentro de	LOC_PREP
por de pronto	LOC_ADV
por descontado	LOC_ADV
por detrás de	LOC_PREP
por duplicado	LOC_ADV
por ejemplo	LOC_ADV
por el centro de	LOC_PREP
por el contrario	LOC_ADV
por contra	LOC_ADV
por el otro lado de	LOC_PREP
por ende	LOC_ADV
por en medio	LOC_ADV
por ensalmo	LOC_ADV
por entonces	LOC_ADV
por esos mundos de Dios	LOC_ADV
por este lado de	LOC_PREP
por favor	LOC_ADV
por hache o por be	LOC_ADV
por igual	LOC_ADV
por intuito	LOC_ADV
por la cuenta que	LOC_CS
por la gracia de Dios	LOC_ADV
por lo bajines	LOC_ADV
por lo bajini	LOC_ADV
por lo bajinis	LOC_ADV
por lo claro	LOC_ADV
por lo común	LOC_ADV
por lo general	LOC_ADV
por lo menos	LOC_ADV
por lo presente	LOC_ADV
por lo pronto	LOC_ADV
por lo tanto	LOC_ADV
por más que digas	LOC_ADV
por medio de	LOC_PREP
por minutos	LOC_ADV
por motivo de	LOC_PREP
por mucho que	LOC_CS
por nada del mundo	LOC_ADV
por ningún concepto	LOC_ADV
por norma general	LOC_ADV
por obra de	LOC_PREP
por obra y gracia de	LOC_PREP
por oídas	LOC_ADV
por onzas	LOC_ADV
por otro lado	LOC_ADV
por pura fórmula	LOC_ADV
por razón de que	LOC_CS
por real decreto	LOC_ADV
por regla general	LOC_ADV
por segundo año consecutivo	LOC_ADV
por separado	LOC_ADV
por si acaso	LOC_ADV
por siempre jamás	LOC_ADV
por si las moscas	LOC_ADV
#por supuesto	LOC_ADV
por testa	LOC_ADV
por todo lo alto	LOC_ADV
por un tris	LOC_ADV
por ventura	LOC_ADV
por virtud de	LOC_PREP
post meridiem	LOC_ADV
post mortem	LOC_ADV
post scriptum	LOC_ADV
potencia de salida	NCFS000
potestad sancionadora	NCFS000
p/o	Y
p. o.	Y
P. O.	Y
p.º	Y
ppal.	Y
p. p.	Y
práctica clínica	NCFS000
prae manibus	LOC_ADV
pral.	Y
precio de mercado	NCMS000
precio máximo	NCMS000
precio mínimo	NCMS000
precio único	NCMS000
precio unitario	NCMS000
predicción del tiempo	NCFS000
predicción meteorológica	NCFS000
# preparador físico	LOC_NC
Presb.	Y
presidencia del gobierno	NCFS000
# presidente del consejo de administración	LOC_NC
presidente del parlamento	NCMS000
presión sanguínea	NCFS000
préstamo hipotecario	NCMS000
presupuesto aprobado	NCMS000
presupuesto nacional	NCMS000
prevención de riesgos laborales	NCFS000
prevención de riesgos	NCFS000
prima donna	NCFN000
prima facie	LOC_ADV
primera comunión	NCFS000
primera guerra mundial	NCFS000
# primer ministro	LOC_NC
primero de mayo	NCMS000
primeros auxilios	NCMP000
primus inter pares	NCMS000
principio de igualdad	NCMS000
principio de legalidad	NCMS000
principios generales del derecho	NCMP000
procedimiento administrativo	NCMS000
procedimiento de evaluación	NCMS000
procedimiento judicial	NCMS000
procesamiento de la información	NCMP000
proceso administrativo	NCMS000
proceso de datos	NCMS000
proceso de desarrollo	NCMS000
proceso de fabricación	NCMS000
proceso de integración	NCMS000
proceso de socialización	NCMS000
proceso educativo	NCMS000
pro domo sua	LOC_ADV
producción agrícola	NCFS000
producción cinematográfica	NCFS000
producción editorial	NCFS000
producción editorial	NCFS000
producto bruto	NCMS000
producto nacional	NCMS000
producto químico	NCMS000
Prof.ª	Y
profesor emérito	NCMS000
profesor titular	NCMS000
pro forma	LOC_ADV
Prof.	Y
programación general	NCMS000
programa de las naciones unidas para el medio ambiente	NCMS000
programa gratuito	NCFS000
progreso económico	NCMS000
pról.	Y
promoción del empleo	NCFS000
promulgación de la ley	NCFS000
propiedad urbana	NCFS000
proposición de ley	NCFS000
proposición no de ley	NCFS000
propter nuptias	LOC_ADV
prosperidad económica	NCFS000
protocolo de kioto	NCMS000
protocolo tcp-ip	NCFS000
protocolo tcp/ip	NCFS000
prov.	Y
proyecto de ley	NCMS000
proyecto empresarial	NCMS000
prueba documental	NCFS000
psicología aplicada	NCFS000
psicología clínica	NCFS000
psicología cognitiva	NCFS000
psicología evolutiva	NCFS000
psicología general	NCFS000
psicología social	NCFS000
P. S.	Y
publicidad comercial	NCFS000
pues bien	LOC_ADV
pues sí que	LOC_CS
pues sí que	LOC_I
puesta en servicio	NCFS000
pulgada agua	NCFS000
pulgada cuadrado	NCFS000
pulgada cúbico	NCFS000
pulgada de agua	NCFS000
pulgada de hg	NCFS000
pulgada Fh segundo Fh segundo	NCFS000
pulgada Fh segundo por segundo	NCFS000
pulgada Fh segundo segundo	NCFS000
pulgada hg	NCFS000
pulgada por segundo al cuadrado	NCFS000
pulgada por segundo cuadrado	NCFS000
pulgada por segundo Fh segundo	NCFS000
pulgada por segundo por segundo	NCFS000
pulgada por segundo segundo	NCFS000
pulgada segundo Fh segundo	NCFS000
pulgada segundo por segundo	NCFS000
pulgada segundo segundo	NCFS000
punto crítico	NCMS000
punto de cruz	NCMS000
punto de equilibrio	NCMS000
punto de partida	NCMS000
punto de referencia	NCMS000
punto focal	NCMS000
puntuación media	NCMS000
P. V. P.	Y
p. v.	Y
P.	Y
p.	Y
pza.	Y
q. b. s. m.	Y
q. b. s. p.	Y
q. D. g.	Y
Q. D. G.	Y
q. e. g. e.	Y
q. e. p. d.	Y
q. e. s. m.	Y
q. s. g. h.	Y
que ni hecho de encargo	LOC_ADV
que ni pintado	LOC_ADV
que pela	LOC_ADV
que si tal que si cual	LOC_ADV
queso fresco	NCMS000
quid divinum	LOC_ADV
quid pro quo	LOC_ADV
quiera que no	LOC_ADV
quieras que no	LOC_ADV
química ambiental	NCFS000
química general	NCMS000
química industrial	NCMS000
rabassa morta	LOC_ADV
rad Fh s	NCFS000
radiación solar	NCFS000
radiación ultravioleta	NCFS000
# radián Fh segundo	LOC_NC
# radián por segundo	LOC_NC
ramo de flores	NCMS000
rara avis	NCCN000
rara vez	LOC_ADV
rata parte	LOC_ADV
rayos x	NCMP000
Rda.	Y
Rdo.	Y
R. D.	Y
reacción química	NCFS000
real decreto ley	NCMS000
reales decretos leyes	NCMS000
reality show	NCMS000
reality shows	NCMP000
recaudación de impuestos	NCMS000
reconocimiento de voz	NCMS000
recurso administrativo	NCMS000
recursos hídricos	NCMP000
recursos públicos	NCMP000
red de datos	NCFS000
red de relaciones	NCFS000
red ethernet	NCFS000
red informática	NCFS000
red privada	NCFS000
red pública	NCFS000
red telefónica	NCFS000
reducción de jornada	NCFS000
reducción de la jornada	NCFS000
reforma constitucional	NCFS000
reforma tributaria	NCFS000
régimen capitalista	NCMS000
régimen democrático	NCMS000
régimen disciplinario	NCMS000
régimen económico	NCMS000
régimen general de la seguridad social	NCMS000
régimen jurídico	NCMS000
régimen político	NCMS000
régimen tributario	NCMS000
registro de datos	NCMS000
regla de oro	NCFS000
regresión lineal	NCFS000
reg.	Y
reino animal	NCMS000
reinserción social	NCMS000
relación bilateral	NCFS000
relación de dependencia	NCFS000
relaciones de producción	NCFP000
relaciones diplomáticas	NCFP000
relaciones humanas	NCFP000
relación jurídica	NCFS000
relación personal	NCFS000
relata refero	LOC_ADV
relata réfero	LOC_ADV
rendimiento escolar	NCMS000
# rentabilidad económica	LOC_NC
renta variable	NCFS000
representación diplomática	NCFS000
representación gráfica	NCFS000
representación legal	NCFS000
representación proporcional	NCFS000
# representante del gobierno	LOC_NC
reproducción asistida	NCFS000
# reproductor de dvd	LOC_NC
república federal	NCFS000
Rep.	Y
requiescat in pace	LOC_ADV
reserva de la biosfera	NCFS000
reserva legal	NCFS000
residencia habitual	NCFS000
residencia oficial	NCFS000
resistencia de materiales	NCFS000
resolución administrativa	NCFS000
resolución impugnada	NCFS000
respecto a	LOC_PREP
respecto a que	LOC_CS
respecto de	LOC_PREP
# responsabilidad administrativa	LOC_NC
# responsabilidad civil	LOC_NC
resultado oficial	NCMS000
retraso mental	NCMS000
revolución cultural	NCFS000
revolución francesa	NCFS000
revolución socialista	NCFS000
Rev.	Y
riesgo social	NCMS000
rigor científico	NCMS000
rigor mortis	NCMN000
río abajo	LOC_ADV
río arriba	LOC_ADV
Río de Janeiro	NPCSG00
R. I. P.	Y
ritmo cardiaco	NCMS000
ritmo de trabajo	NCMS000
rock and roll	NCMS000
rock and roll	NCMS000
rock 'n' roll	NCMS000
rock'n'roll	NCMS000
rock & roll	NCMS000
rock&roll	NCMS000
role playing	NCMS000
roll on	LOC_AQ0CN0
R. O.	Y
r.º	Y
r.p.m.	NCFN000
r. p. m.	Y
RR. HH.	Y
Rte.	Y
rum rum	NCMS000
Rvda.	Y
Rvdma.	Y
Rvdmo.	Y
Rvdo.	Y
Rvd.	Y
R.	Y
sábado santo	NCMS000
sagrada familia	NCMS000
S. A. I.	Y
sala de prensa	NCFS000
salario base	NCMS000
salario mínimo	NCMS000
salga lo que salga	LOC_ADV
# salón de plenos	LOC_NC
salsa de tomate	NCFS000
salud ambiental	NCFS000
salud bucodental	NCFS000
San Cristóbal y Nieves	NPCSG00
santa misa	NCFS000
Sant Cugat del Vallès	NPCSG00
Sant Cugat	NPCSG00
santísima trinidad	NCMS000
santísimo sacramento	NCMS000
Sant Joan Despí	NPCSG00
santo oficio	NCMS000
santo sepulcro	NCMS000
S. A. R.	Y
S. A. S.	Y
s/a	Y
S. A.	Y
s. a.	Y
S.ª	Y
s/c	Y
s. c.	Y
Sdad.	Y
S. D. M.	Y
s. d.	Y
sea cual fuere	LOC_ADV
sea lo que fuere	LOC_ADV
secretaría de estado	NCFS000
secretaría de gobierno	NCFS000
secretaría general	NCFS000
sector agrario	NCMS000
sector agrícola	NCMS000
sector económico	NCMS000
sector turístico	NCMS000
según como	LOC_ADV
segunda guerra mundial	NCFS000
segunda lengua	NCFS000
según el decir de	LOC_PREP
según que	LOC_CS
seguridad del estado	NCFS000
seguridad e higiene	NCFS000
seguridad internacional	NCFS000
seguridad jurídica	NCFS000
seguridad personal	NCFS000
seguro de accidentes	NCMS000
seguro de vida	NCMS000
seguro obligatorio	NCMS000
seguro social	NCMS000
selección nacional	NCFS000
selección natural	NCFS000
selva tropical	NCFS000
semejante a	LOC_PREP
sensu lato	LOC_ADV
sensu stricto	LOC_ADV
sentencia firme	NCFS000
sentido contrario	NCMS000
sentido crítico	NCMS000
sentido del humor	NCMS000
sentido de responsabilidad	NCMS000
sentido literal	NCMS000
sentimiento de culpa	NCMS000
separación de poderes	NCFS000
servicio asistencial	NCMS000
servicio de apoyo	NCMS000
servicio de atención al cliente	NCMS000
servicio de información	NCMS000
servicio de urgencias	NCMS000
servicio educativo	NCMS000
servicio jurídico	NCMS000
servicio meteorológico	NCMS000
servicio público	NCMS000
servicios funerarios	NCMP000
servicios sociales	NCMP000
servicios urbanos	NCMP000
servicio turístico	NCMS000
servidor dns	NCMS000
servidor proxy	NCMS000
servidor web	NCMS000
sesión continua	NCFS000
sesión plenaria	NCFS000
s. e. u o.	Y
sex appeal	NCMS000
sex shop	NCMS000
sex symbol	NCMS000
sex symbols	NCMP000
s/e	Y
S. E.	Y
s. e.	Y
s/f	Y
s. f.	Y
Sgto.	Y
show business	NCMS000
si acaso	LOC_ADV
si bien se mira	LOC_ADV
siempre y cuando	LOC_CS
# siendo así	LOC_ADV # QUE[5]
sig.	Y
silencio administrativo	NCMS000
similar a	LOC_PREP
sin ambages	LOC_ADV
sin chistar ni mistar	LOC_ADV
sin comerlo ni beberlo	LOC_ADV
sin contar con	LOC_PREP
sin contar con que	LOC_CS
síndrome de down	NCMS000
sin duda alguna	LOC_ADV
sine die	LOC_ADV
sine qua non	LOC_ADV
singularia tantum	LOC_ADV
sin ir más lejos	LOC_ADV
sin lugar a dudas	LOC_ADV
sin más ni más	LOC_ADV
sin necesidad de	LOC_PREP
sin ninguna duda	LOC_ADV
si no es por	LOC_PREP
si no es que	LOC_CC
sino que	LOC_CC
sin pena ni gloria	LOC_ADV
sin perjuicio de	LOC_PREP
sin qué ni para qué	LOC_ADV
sin ton ni son	LOC_ADV
sin trastes	LOC_ADV
sin venir a pelo	LOC_ADV
sistema abierto	NCMS000
sistema de clasificación	NCFS000
sistema de comunicación	NCFS000
sistema de correo	NCFS000
sistema de defensa	NCFS000
sistema de ficheros	NCFS000
sistema de gestión	NCFS000
sistema de gobierno	NCFS000
sistema de información geográfica	NCFS000
sistema de juego	NCFS000
sistema de medición	NCFS000
sistema democrático	NCFS000
sistema de partidos	NCFS000
sistema de producción	NCFS000
sistema de seguridad	NCFS000
sistema económico	NCFS000
sistema educativo	NCFS000
sistema electoral	NCFS000
sistema electrónico	NCFS000
sistema federal	NCFS000
sistema fiscal	NCFS000
sistema informático	NCFS000
sistema métrico	NCMS000
sistema nacional de salud	NCMS000
sistema nervioso central	NCMS000
sistema nervioso	NCMS000
sistema social	NCMS000
sistema tributario	NCMS000
sitio web	NCMS000
situación administrativa	NCFS000
situación de emergencia	NCFS000
situación económica	NCFS000
situación financiera	NCFS000
situación jurídica	NCFS000
S. I.	Y
S. J.	Y
s/l	Y
S. L.	Y
s. l.	Y
S. M.	Y
snack bar	NCMS000
snack bars	NCMP000
s/n	Y
s. n.	Y
soberanía nacional	NCFS000
soberanía popular	NCFS000
sobre manera	LOC_ADV
sobre seguro	LOC_ADV
sociedad capitalista	NCFS000
sociedad financiera	NCFS000
socio fundador	NCMS000
sociología política	NCFS000
Soc.	Y
# software educativo	LOC_NC
solidaridad internacional	NCFS000
so pena de que	LOC_CS
so pena que	LOC_CS
# soporte físico	LOC_NC
sotto voce	LOC_ADV
# Spanish multiwords file used for chunking
S. P.	Y
Srs.	Y
Sres.	Y
Sr.ª	Y
S. R. C.	Y
Sri Lanka	NPCSG00
S. R. M.	Y
Srta.	Y
Sr.	Y
s. s. s.	Y
S. S.	Y
s. s.	Y
stabat mater	NCMN000
statu quo	NCMN000
Sta.	Y
Sto.	Y
stricto sensu	LOC_ADV
sub iudice	LOC_ADV
sub judice	LOC_ADV
subsecretario de estado	NCMS000
sub voce	LOC_ADV
suelo no urbanizable	NCMS000
suelo urbanizable	NCMS000
sui géneris	LOC_ADV
sui generis	LOC_ADV
suministro de energía eléctrica	NCMS000
súper 8	NCFS000
# superficie plana	LOC_NC
superficie útil	NCFS000
supuesto que	LOC_CS
sustancia química	NCFS000
s/v	Y
s. v.	Y
S.	Y
s.	Y
tabula gratulatoria	NCFS000
tabula rasa	NCFS000
tal como	LOC_CS
tal cual	LOC_ADV
# taller mecánico	LOC_NC
tal vez	LOC_ADV
tal y como	LOC_CS
tamaño de la población	NCMS000
tamaño natural	NCMS000
tan pronto como	LOC_CS
tan siquiera	LOC_ADV
tanto más que	LOC_CS
tanto menos que	LOC_CS
tanto peor	LOC_ADV
tanto por ciento	NCMS000
tanto por tanto	LOC_ADV
Tantum ergo	NCMS000
tarjeta de identificación	NCFS000
tarjeta de red	NCFS000
tarjeta de sonido	NCFS000
tarjeta de vídeo	NCFS000
tarjeta gráfica	NCFS000
tarjeta pcmcia	NCFS000
tarjeta roja	NCFS000
tasa de cambio	NCFS000
tasa de crecimiento	NCFS000
tasa de desempleo	NCFS000
tasa de inflación	NCFS000
tasa de paro	NCFS000
taza de café	NCFS000
técnica de evaluación	NCFS000
técnica mixta	NCFS000
técnico auxiliar	NCMS000
técnico económico	NCMS000
tecnología avanzada	NCFS000
tecnología educativa	NCFS000
tejido adiposo	NCMS000
tejido conectivo	NCMS000
telefonía ip	NCMS000
teléf.	Y
televisión educativa	NCFS000
tel.	Y
tema de investigación	NCFS000
temperatura del agua	NCFS000
temperatura extrema	NCFS000
tensión arterial	NCFS000
teoría crítica	NCFS000
teoría de la comunicación	NCFS000
teoría de la relatividad	NCFS000
teoría económica	NCFS000
teoría política	NCFS000
terapia física	NCFS000
terapia ocupacional	NCFS000
tercera división	NCFS000
tercera edad	NCFS000
terreno de juego	NCMS000
territorio nacional	NCMS000
# tesis doctoral	LOC_NC
testigo de jehová	NCMS000
test.º	Y
té verde	NCMS000
texto legal	NCMS000
texto original	NCMS000
tfno.	Y
tie break	NCMS000
tie breaks	NCMP000
tiempo de exposición	NCMS000
tiempo de servicio	NCMS000
tienda especializada	NCFS000
tierra adentro	LOC_ADV
tipo de cambio	NCMS000
tipo de datos	NCMS000
tipo de trabajo	NCMS000
tipo de vegetación	NCMS000
tira cómica	NCFS000
tiro libre	NCMS000
titulación académica	NCFS000
título académico	NCMS000
título de bachiller	NCMS000
título de propiedad	NCMS000
título oneroso	NCMS000
título preliminar	NCMS000
título profesional	NCMS000
título superior	NCMS000
tít.	Y
todo lo contrario	LOC_ADV
todo lo contrario	LOC_I
todo oídos	LOC_ADV
todo quisque	NCMS000
toga picta	LOC_ADV
toma de decisiones	NCFS000
tonelada métrico	NCFS000
tono de voz	NCMS000
tono muscular	NCMS000
top model	NCCS000
top models	NCCP000
totum revolutum	NCMS000
tour de force	NCMS000
trabajo asalariado	NCMS000
trabajo de campo	NCMS000
trabajo doméstico	NCMS000
trabajo en grupo	NCMS000
trabajo grupal	NCMS000
trabajo nocturno	NCMS000
trabajos forzados	NCMP000
tracto gastrointestinal	NCMS000
traducción automática	NCFS000
trad.	Y
tráfico de drogas	NCMS000
transacción comercial	NCFS000
transferencia de datos	NCFS000
transferencia de información	NCFS000
transmisión de datos	NCFS000
# transporte aéreo	LOC_NC
transporte de viajeros	NCMS000
transporte público	NCMS000
tratado de la unión europea	NCMS000
tratado de paz	NCMS000
tratamiento de aguas residuales	NCMS000
tratamiento de datos	NCMS000
tratamiento de imágenes	NCMS000
tratamiento térmico	NCMS000
# tribunal de apelación	LOC_NC
tribunal superior de justicia	NCMS000
Trinidad y Tobago	NPCSG00
Tte.	Y
# tumor cerebral	LOC_NC
turismo activo	NCMS000
tutti quanti	LOC_ADV
t.	Y
Uds.	Y
Ud.	Y
una vez que	LOC_CS
una y no más	LOC_ADV
un día u otro	LOC_ADV
un día y otro	LOC_ADV
unidad administrativa	NCFS000
unidad de control	NCFS000
unidad de cuidados intensivos	NCFS000
unidad de gestión	NCFS000
unidad de información	NCFS000
unidad de masa atómica	NCFS000
unidad de medida	NCFS000
unidad de producción	NCFS000
unidad de tiempo	NCFS000
unidad didáctica	NCFS000
unidad familiar	NCFS000
unión aduanera	NCFS000
unión económica	NCFS000
unión económica y monetaria	NCFS000
unión europea	NCFS000
unión general de trabajadores	NCFS000
universidad del país vasco	NCFS000
universidad nacional de educación a distancia	NCFS000
Univ.	Y
uno por uno	LOC_ADV
un poco tarde	LOC_ADV
urbi et orbi	LOC_ADV
urbi et orbi	LOC_AQ0CN0
uso privado	NCMS000
uso residencial	NCMS000
usuario registrado	NCMS000
utilidad pública	NCFS000
ut retro	LOC_ADV
ut supra	LOC_ADV
U.	Y
vade retro	LOC_ADV
vae victis	LOC_ADV
Valmte.	Y
valor absoluto	NCMS000
valor artístico	NCMS000
valor de mercado	NCMS000
valor económico	NCMS000
valores mobiliarios	NCMP000
valor estimado	NCMS000
valor inicial	NCMS000
valor medio	NCMS000
valor nominal	NCMS000
valor numérico	NCMS000
valor probatorio	NCMS000
valor social	NCMS000
vapor de agua	NCMS000
varita mágica	NCFS000
V. A. R.	Y
vaso de vino	NCMS000
V. A.	Y
vaya por dios	LOC_I
vaya por Dios	LOC_I
V. B.	Y
Vda.	Y
Vdo.	Y
Vds.	Y
Vd.	Y
velis nolis	LOC_ADV
velocidad de la luz	NCFS000
velocidad del viento	NCFS000
velocidad de transferencia	NCFS000
velocidad de transmisión	NCFS000
velocidad máxima	NCFS000
venta de acciones	NCFS000
venta directa	NCFS000
vera effigies	LOC_ADV
verbi gratia	LOC_ADV
V. E.	Y
v Fh m	NCFS000
v. gr.	Y
v. g.	Y
viabilidad económica	NCFS000
vía crucis	NCMN000
vía férrea	NCFS000
# viaje de ida	LOC_NC
vía respiratoria	NCFS000
vicario general	NCMS000
vida en sociedad	NCFS000
vida profesional	NCFS000
vídeo vhs	NCMS000
vid.	Y
villa olímpica	NCFS000
violencia doméstica	NCFS000
violencia familiar	NCFS000
virus de la inmunodeficiencia humana	NCMN000
vitamina a	NCFS000
vitamina c	NCFS000
vitamina d	NCFS000
vitamina e	NCFS000
viva voce	LOC_ADV
vivienda habitual	NCFS000
vivienda social	NCFS000
V. I.	Y
V. M.	Y
V.º B.º	Y
# volt Fh metro	LOC_NC
# volt por metro	LOC_NC
volumen de negocios	NCMS000
volumen de trabajo	NCMS000
voluntariado social	NCMS000
vol.	Y
V. O. S.	Y
voto a bríos	LOC_ADV
voto particular	NCMS000
vox populi	LOC_ADV
vox populi	NCFS000
V. O.	Y
v.º	Y
V. P.	Y
V. S. I.	Y
V. S.	Y
vs.	Y
vta.	Y
vto.	Y
vv. aa.	Y
VV. AA.	Y
v/	Y
v.	Y
V.	Y
# watt Fh estereoradián	LOC_NC
# watt Fh metro Fh grado kelvin	LOC_NC
# watt Fh metro Fh kelvin	LOC_NC
# watt Fh metro por grado kelvin	LOC_NC
# watt Fh metro por kelvin	LOC_NC
# watt por estereoradián	LOC_NC
# watt por metro Fh grado kelvin	LOC_NC
# watt por metro Fh kelvin	LOC_NC
# watt por metro por grado kelvin	LOC_NC
# watt por metro por kelvin	LOC_NC
W. C.	Y
w Fh m K	NCFS000
w Fh srad	NCFS000
wi fi	NCMN000
wind surfing	NCMS000
wind surf	NCMS000
Xto.	Y
ya es mucho decir	LOC_ADV
ya que	LOC_CS
yarda cuadrado	NCFS000
yarda cúbico	NCFS000
ya será menos	LOC_ADV
zona arqueológica	NCFS000
zona comercial	NCFS000
zona de descanso	NCFS000
zona de libre comercio	NCFS000
zona de trabajo	NCFS000
zona franca	NCFS000
zona horaria	NCFS000
zona privada	NCFS000
zona residencial	NCFS000
zona restringida	NCFS000
zona turística	NCFS000

