# Lista de errores ortográficos comunes en español.
# Extraído de https://es.wikipedia.org/wiki/Wikipedia:Lista_de_errores_ortogr%C3%A1ficos_comunes/M%C3%A1quinas
#
a basto=abasto
A basto=Abasto
absorver=absorber
Absorver=Absorber
absorviendo=absorbiendo
Absorviendo=Absorbiendo
aca=acá
Aca=Acá
academica=académica
Academica=Académica
academicamente=académicamente
Academicamente=Académicamente
academico=académico
Academico=Académico
accion=acción
Accion=Acción
aceptacion=aceptación
Aceptacion=Aceptación
acceptacion=aceptación
Acceptacion=Aceptación
acetado=aceptado
Acetado=Aceptado
actualize=actualice
Actualize=Actualice
ademas=además
Ademas=Además
administracion=administración
Administracion=Administración
aerea=aérea
Aerea=Aérea
aereo=aéreo
Aereo=Aéreo
aficion=afición
Aficion=Afición
aficcion=afición
Aficcion=Afición
aficción=afición
Aficción=Afición
ahi=ahí
Ahi=Ahí
al Cairo=a El Cairo
Al Cairo=A El Cairo
al Ejido=a El Ejido
Al Ejido=A El Ejido
album=álbum
Album=Álbum
alcansado=alcanzado
Alcansado=Alcanzado
alevin=alevín
Alevin=Alevín
algun=algún
Algun=Algún
alli=allí
Alli=Allí
alla=allá
Alla=Allá
almorzé=almorcé
Almorzé=Almorcé
almuerze=almuerce 
Almuerze=Almuerce 
al rededor=alrededor
Al rededor=Alrededor
antigüo=antiguo
Antigüo=Antiguo
aogado=ahogado
Aogado=Ahogado
apesar=a pesar
Apesar=A pesar
aprobechar=aprovechar   
Aprobechar=Aprovechar   
aqui=aquí
Aqui=Aquí
arabe=árabe
Arabe=Árabe
arbol=árbol
Arbol=Árbol
area=área
Area=Área
articulacion=articulación
Articulacion=Articulación
asi=así
Asi=Así
atencion=atención
Atencion=Atención
atlantico=atlántico
Atlantico=Atlántico
atrabesado=atravesado
Atrabesado=Atravesado
atrabezado=atravesado
Atrabezado=Atravesado
atravezado=atravesado
Atravezado=Atravesado
atrabesar=atravesar
Atrabesar=Atravesar
atrabezar=atravesar
Atrabezar=Atravesar
atravezar=atravesar
Atravezar=Atravesar
automovil=automóvil
Automovil=Automóvil
avion=avión
Avion=Avión
azucar=azúcar
Azucar=Azúcar
bibliografia=bibliografía
Bibliografia=Bibliografía
bién=bien
Bién=Bien
Bogota=Bogotá
buho=búho
Buho=Búho
cadaver=cadáver
Cadaver=Cadáver
cafe=café
Cafe=Café
cafeteria=cafetería
Cafeteria=Cafetería
camaleon=camaleón
Camaleon=Camaleón
camara=cámara
Camara=Cámara
cancion=canción
Cancion=Canción
candadear=candear
Candadear=Candear
caracter=carácter
Caracter=Carácter
caracteristica=característica
Caracteristica=Característica
carroceria=carrocería
Carroceria=Carrocería
catastrofe=catástrofe
Catastrofe=Catástrofe
catastrofica=catastrófica
Catastrofica=Catastrófica
catastrofico=catastrófico
Catastrofico=Catastrófico
categoria=categoría
Categoria=Categoría
cién=cien
Cién=Cien
cienes=cientos
Cienes=Cientos
CD's=CD
CDs=CD
cogeran=cogerán
Cogeran=Cogerán
cogia=cogía
Cogia=Cogía
cogian=cogían
Cogian=Cogían
cojer=coger
Cojer=Coger
cojen=cogen
Cojen=Cogen
cojerán=cogerán
Cojerán=Cogerán
cojía=cogía
Cojía=Cogía
cojia=cogía
Cojia=Cogía
cojían=cogían
Cojían=Cogían
cojió=cogió
Cojió=Cogió
companía=compañía
Companía=Compañía
compañia=compañía
Compañia=Compañía
compasion=compasión
Compasion=Compasión
comun=común
Comun=Común
comunmente=comúnmente
Comunmente=Comúnmente
conección=conexión
Conección=Conexión
cono urbano=conurbano
Cono urbano=Conurbano
consideracion=consideración
Consideracion=Consideración
constituída=constituida
Constituída=Constituida
constituído=constituido
Constituído=Constituido
construído=construido
Construído=Construido
construír=construir
Construír=Construir
continuan=continúan
Continuan=Continúan
contínuo=continuo
Contínuo=Continuo
convirtio=convirtió
Convirtio=Convirtió
cortesmente=cortésmente
Cortesmente=Cortésmente
cronologica=cronológica
Cronologica=Cronológica
cronologicamente=cronológicamente
Cronologicamente=Cronológicamente
cronologico=cronológico
Cronologico=Cronológico
da a lugar a=da lugar a
Da a lugar a=Da lugar a
dar a lugar a=dar lugar a
Dar a lugar a=Dar lugar a
daría a lugar a=daría lugar a
Daría a lugar a=Daría lugar a
dá=da
Dá=Da
definio=definió
Definio=Definió
del Cairo=de El Cairo
Del Cairo=De El Cairo
del Ejido=de El Ejido
Del Ejido=De El Ejido
del interfaz=de la interfaz
Del interfaz=De la interfaz
delfin=delfín
Delfin=Delfín
desconto=descontó
Desconto=Descontó
descuentado=descontado
Descuentado=Descontado
desenrredado=desenredado
Desenrredado=Desenredado
desenrredar=desenredar
Desenrredar=Desenredar
desovediente=desobediente
Desovediente=Desobediente
deshechar=desechar
Deshechar=Desechar
deshechando=desechando
Deshechando=Desechando
despues=después
Despues=Después
dia=día
Dia=Día
dias=días
Dias=Días
dieciseis=dieciséis
Dieciseis=Dieciséis
diéz=diez
Diéz=Diez
dificil=difícil
Dificil=Difícil
dificilmente=difícilmente
Dificilmente=Difícilmente
difucion=difusión
Difucion=Difusión
difución=difusión
Difución=Difusión
difusion=difusión
Difusion=Difusión
dio a lugar a=dio lugar a
Dio a lugar a=Dio lugar a
dió=dio
Dió=Dio
discución=discusión
Discución=Discusión
discucion=discusión
Discucion=Discusión
discusion=discusión
Discusion=Discusión
discursion=discusión
Discursion=Discusión
discurcion=discusión
Discurcion=Discusión
disolucion=disolución
Disolucion=Disolución
distorción=distorsión
Distorción=Distorsión
distorcionado=distorsionado
Distorcionado=Distorsionado
distribuído=distribuido
Distribuído=Distribuido
duodecimo=duodécimo
Duodecimo=Duodécimo
dotor=doctor
Dotor=Doctor
doptor=doctor
Doptor=Doctor
e hielo=y hielo
E hielo=Y hielo
e hierro=y hierro
E hierro=Y hierro
e iones=y iones
E iones=Y iones
ebano=ébano
Ebano=Ébano
eclesiastico=eclesiástico
Eclesiastico=Eclesiástico
eclesiasticos=eclesiásticos
Eclesiasticos=Eclesiásticos
el fue=él fue
El fue=Él fue
el interfaz=la interfaz
El interfaz=La interfaz
el Osasuna=Osasuna
El Osasuna=Osasuna
embarcacion=embarcación
Embarcacion=Embarcación
enbarcacion=embarcación
Enbarcacion=Embarcación
enbarcación=embarcación
Enbarcación=Embarcación
empezo=empezó
Empezo=Empezó
enlaze=enlace
Enlaze=Enlace
eolico=eólico
Eolico=Eólico
enrredado=enredado
Enrredado=Enredado
enrredar=enredar
Enrredar=Enredar
equalización=ecualización
Equalización=Ecualización
equalizador=ecualizador
Equalizador=Ecualizador
equalizar=ecualizar
Equalizar=Ecualizar
espiritu=espíritu
Espiritu=Espíritu
estadío=estadio
Estadío=Estadio
estan=están
Estan=Están
estandard=estándar
Estandard=Estándar
estándard=estándar
Estándard=Estándar
etc...=etc.
Etc...=Etc.
etimologia=etimología
Etimologia=Etimología
exámen=examen
Exámen=Examen
examenes=exámenes
Examenes=Exámenes
exhuberante=exuberante
Exhuberante=Exuberante
exitar=excitar
Exitar=Excitar
exito=éxito
Exito=Éxito
exemplo=ejemplo
Exemplo=Ejemplo
explendor=esplendor
Explendor=Esplendor
extrangero=extranjero
Extrangero=Extranjero
estranjero=extranjero
Estranjero=Extranjero
estrangero=extranjero
Estrangero=Extranjero
extrangero=extranjero
Extrangero=Extranjero
extricta=estricta
Extricta=Estricta
extricto=estricto
Extricto=Estricto
extrictamente=estrictamente
Extrictamente=Estrictamente
espia=espía
Espia=Espía
esprecion=expresión
Esprecion=Expresión
espreción=expresión
Espreción=Expresión
espresion=expresión
Espresion=Expresión
espresión=expresión
Espresión=Expresión
expreción=expresión
Expreción=Expresión
expresion=expresión
Expresion=Expresión
facil=fácil
Facil=Fácil
facilmente=fácilmente
Facilmente=Fácilmente
fanatica=fanática
Fanatica=Fanática
fanaticamente=fanáticamente
Fanaticamente=Fanáticamente
fanatico=fanático
Fanatico=Fanático
fé=fe
Fé=Fe
ficcion=ficción
Ficcion=Ficción
fisica=física
Fisica=Física
fluído=fluido
Fluído=Fluido
fricion=fricción
Fricion=Fricción
frición=fricción
Frición=Fricción
friccion=fricción
Friccion=Fricción
fusion=fusión
Fusion=Fusión
fución=fusión
Fución=Fusión
fué=fue
Fué=Fue
fuí=fui
Fuí=Fui
funcion=función
Funcion=Función
fusion=fusión
Fusion=Fusión
futil=fútil
Futil=Fútil
guión=guion
Guión=Guion
Guipuzcoa=Guipúzcoa
gustaria=gustaría
Gustaria=Gustaría
Gutierrez=Gutiérrez
habia=había
Habia=Había
haiga=haya
Haiga=Haya
habian=habían
Habian=Habían
hechar=echar
Hechar=Echar
hechado=echado
Hechado=Echado
herbivoro=herbívoro
Herbivoro=Herbívoro
herviboro=herbívoro
Herviboro=Herbívoro
hervíboro=herbívoro
Hervíboro=Herbívoro
hervivoro=herbívoro
Hervivoro=Herbívoro
hervívoro=herbívoro
Hervívoro=Herbívoro
hermita=ermita
Hermita=Ermita
heroe=héroe
Heroe=Héroe
heróica=heroica
Heróica=Heroica
heróico=heroico
Heróico=Heroico
hibridización=hibridación
Hibridización=Hibridación
hinduísmo=hinduismo
Hinduísmo=Hinduismo
hinduísta=hinduista
Hinduísta=Hinduista
homogenea=homogénea
Homogenea=Homogénea
homogeneo=homogéneo
Homogeneo=Homogéneo
hormigon=hormigón
Hormigon=Hormigón
ideologia=ideología
Ideologia=Ideología
idiologia=ideología
Idiologia=Ideología
ideologica=ideológica
Ideologica=Ideológica
ideologicamente=ideológicamente
Ideologicamente=Ideológicamente
ideologico=ideológico
Ideologico=Ideológico
imágen=imagen
Imágen=Imagen
imagenes=imágenes
Imagenes=Imágenes
IMDB=IMDb
incluído=incluido
Incluído=Incluido
incluír=incluir
Incluír=Incluir
indice=índice
Indice=Índice
interface=interfaz
Interface=Interfaz
interperie=intemperie
Interperie=Intemperie
inutil=inútil
Inutil=Inútil
invasion=invasión
Invasion=Invasión
israeli=israelí
Israeli=Israelí
israelies=israelíes
Israelies=Israelíes
jardin=jardín
Jardin=Jardín
jente=gente
Jente=Gente
jesúita=jesuita
Jesúita=Jesuita
jóven=joven
Jóven=Joven
judia=judía
Judia=Judía
judias=judías
Judias=Judías
judio=judío
Judio=Judío
judios=judíos
Judios=Judíos
Km=km
km2=km²
Km2=km²
kms=km
Kms=km
lampara=lámpara
Lampara=Lámpara
LED=led
leds=ledes
Leds=Ledes
LEDs=ledes
le hecha=le echa
Le hecha=Le echa
leido=leído
Leido=Leído
leon=león
Leon=León
lider=líder
Lider=Líder
linea=línea
Linea=Línea
lineas=líneas
Lineas=Líneas
linia=línea
Linia=Línea
llendo=yendo
Llendo=Yendo
llevada acabo=llevada a cabo
Llevada acabo=Llevada a cabo
llevado acabo=llevado a cabo
Llevado acabo=Llevado a cabo
llevaron acabo=llevaron a cabo
Llevaron acabo=Llevaron a cabo
llevó acabo=llevó a cabo
Llevó acabo=Llevó a cabo
lluviendo=lloviendo
Lluviendo=Lloviendo
logica=lógica
Logica=Lógica
logicamente=lógicamente
Logicamente=Lógicamente
logico=lógico
Logico=Lógico
lo hecha=lo echa
Lo hecha=Lo echa
lonjeva=longeva
Lonjeva=Longeva
lonjevo=longevo
Lonjevo=Longevo
lus=luz
Lus=Luz
luses=luces
Luses=Luces
luzes=luces
Luzes=Luces
mecanica=mecánica
Mecanica=Mecánica
mecanicamente=mecánicamente
Mecanicamente=Mecánicamente
mecanico=mecánico
Mecanico=Mecánico
magica=mágica
Magica=Mágica
magico=mágico
Magico=Mágico
martir=mártir
Martir=Mártir
maxima=máxima
Maxima=Máxima
maximo=máximo
Maximo=Máximo
mayoria=mayoría
Mayoria=Mayoría
mayuscula=mayúscula
Mayuscula=Mayúscula
mayusculo=mayúsculo
Mayusculo=Mayúsculo
Mejico=Méjico
metodologia=metodología
Metodologia=Metodología
Mexico=México
míl=mil
Míl=Mil
minima=mínima
Minima=Mínima
minimo=mínimo
Minimo=Mínimo
minoria=minoría
Minoria=Minoría
minuscula=minúscula
Minuscula=Minúscula
minusculo=minúsculo
Minusculo=Minúsculo
mitologia=mitología
Mitologia=Mitología
mitologica=mitológica
Mitologica=Mitológica
mitologico=mitológico
Mitologico=Mitológico
mitomana=mitómana
Mitomana=Mitómana
mitomania=mitomanía
Mitomania=Mitomanía
mitomano=mitómano
Mitomano=Mitómano
monton=montón
Monton=Montón
movil=móvil
Movil=Móvil
murciegalo=murciélago
Murciegalo=Murciélago
murciégalo=murciélago
Murciégalo=Murciélago
murio=murió
Murio=Murió
musica=música
Musica=Música
nacio=nació
Nacio=Nació
nadien=nadie
Nadien=Nadie
nadies=nadie
Nadies=Nadie
ningun=ningún
Ningun=Ningún
ningúna=ninguna
Ningúna=Ninguna
ningúno=ninguno
Ningúno=Ninguno
#N°=n.º # see NUMERO
#nº=n.º # see NUMERO
ºC=°C
oceano=océano
Oceano=Océano
ºF=°F
olimpica=olímpica
Olimpica=Olímpica
olimpicamente=olímpicamente
Olimpicamente=Olímpicamente
olimpico=olímpico
Olimpico=Olímpico
operacion=operación
Operacion=Operación
oraculo=oráculo
Oraculo=Oráculo
órden=orden
Órden=Orden
organica=orgánica
Organica=Orgánica
organico=orgánico
Organico=Orgánico
organo=órgano
Organo=Órgano
orígen=origen
Orígen=Origen
origenes=orígenes
Origenes=Orígenes
osea=o sea
Osea=O sea
oceano pacifico=océano Pacífico
Oceano pacifico=Océano Pacífico
ONG's=ONG
ONGs=ONG
OVNI's=ovni
OVNIs=ovni
pagina=página
Pagina=Página
pais=país
Pais=País
participacion=participación
Participacion=Participación
pasion=pasión
Pasion=Pasión
pelicula=película 
Pelicula=Película 
peloton=pelotón
Peloton=Pelotón
perfíl=perfil
Perfíl=Perfil
persuación=persuasión
Persuación=Persuasión
pinguino=pingüino
Pinguino=Pingüino
politica=política
Politica=Política
politicamente=políticamente
Politicamente=Políticamente
politico=político
Politico=Político
por contra=por el contrario
Por contra=Por el contrario
posmortem=post mórtem
Posmortem=Post mórtem
posmorten=post mórtem
Posmorten=Post mórtem
post morten=post mórtem
Post morten=Post mórtem
postmorten=post mórtem
Postmorten=Post mórtem
practicamente=prácticamente
Practicamente=Prácticamente
prerequisito=prerrequisito
Prerequisito=Prerrequisito
pre-requisito=prerrequisito
Pre-requisito=Prerrequisito
prevencion=prevención
Prevencion=Prevención
programacion=programación
Programacion=Programación
promocion=promoción
Promocion=Promoción
protejer=proteger
Protejer=Proteger
publicamente=públicamente
Publicamente=Públicamente
quiza=quizá
Quiza=Quizá
quizas=quizás
Quizas=Quizás
quizo=quiso
Quizo=Quiso
rapido=rápido
Rapido=Rápido
rapida=rápida
Rapida=Rápida
regilla=rejilla
Regilla=Rejilla
remplazar=reemplazar
Remplazar=Reemplazar
republica=república
Republica=República
resolucion=resolución
Resolucion=Resolución
restaurant=restaurante
Restaurant=Restaurante
revizado=revisado
Revizado=Revisado
revizar=revisar
Revizar=Revisar
revolucion=revolución
Revolucion=Revolución
rocin=rocín
Rocin=Rocín
ruído=ruido
Ruído=Ruido
sacerdotiza=sacerdotisa
Sacerdotiza=Sacerdotisa
sazon=sazón
Sazon=Sazón
se a=se ha
Se a=Se ha
séis=seis
Séis=Seis
segun=según
Segun=Según
sera=será
Sera=Será
serpentin=serpentín
Serpentin=Serpentín
sinembargo=sin embargo
Sinembargo=Sin embargo
sinfin=sinfín
Sinfin=Sinfín
slogan=eslogan
Slogan=Eslogan
sóla=sola
Sóla=Sola
sólamente=solamente
Sólamente=Solamente
sólo=solo
Sólo=Solo
solucion=solución
Solucion=Solución
substituir=sustituir
Substituir=Sustituir
estándard=estándar
Estándard=Estándar
subrraya=subraya
Subrraya=Subraya
subrrayado=subrayado
Subrrayado=Subrayado
subrrayar=subrayar
Subrrayar=Subrayar
superfície=superficie
Superfície=Superficie
supérflua=superflua
Supérflua=Superflua
tagea=tajea
Tagea=Tajea
talvez=tal vez
Talvez=Tal vez
tambien=también
Tambien=También
tanbien=también
Tanbien=También
tanbién=también
Tanbién=También
tecnica=técnica
Tecnica=Técnica
technica=técnica
Technica=Técnica
tecnicamente=técnicamente
Tecnicamente=Técnicamente
tecnico=técnico
Tecnico=Técnico
tí=ti
Tí=Ti
tia=tía
Tia=Tía
tio=tío
Tio=Tío
tipica=típica
Tipica=Típica
tipicamente=típicamente
Tipicamente=Típicamente
tipico=típico
Tipico=Típico
tradució=tradujo
Tradució=Tradujo
tradución=traducción
Tradución=Traducción
traducion=traducción
Traducion=Traducción
tradución=traducción
Tradución=Traducción
traduccion=traducción
Traduccion=Traducción
traf=tráf
Traf=Tráf
tunel=túnel
Tunel=Túnel
ubicacion=ubicación
Ubicacion=Ubicación
ultimamente=últimamente
Ultimamente=Últimamente
ultimo=último
Ultimo=Último
ultimos=últimos
Ultimos=Últimos
un interfaz=una interfaz
Un interfaz=Una interfaz
undecimo=undécimo
Undecimo=Undécimo
unica=única
Unica=Única
unicamente=únicamente
Unicamente=Únicamente
unico=único
Unico=Único
util=útil
Util=Útil
vacear=vaciar
Vacear=Vaciar
vease=véase
Vease=Véase
veintidos=veintidós
Veintidos=Veintidós
veintiseis=veintiséis
Veintiseis=Veintiséis
ventiseis=veintiséis
Ventiseis=Veintiséis
ventiséis=veintiséis
Ventiséis=Veintiséis
veintitres=veintitrés
Veintitres=Veintitrés
ventitres=veintitrés
Ventitres=Veintitrés
ventitrés=veintitrés
Ventitrés=Veintitrés
vision=visión
Vision=Visión
vizión=visión
Vizión=Visión
via=vía
Via=Vía
vió=vio
Vió=Vio
watios=vatios
Watios=Vatios
watíos=vatios
